casilla_id,edo_id,pri_pvem,pan,panal,prd_pt_conv,psd,otros,total,estrato
93995,21,45,196,4,146,18,2,411,150
68910,15,46,94,2,258,22,5,427,83
34939,11,11,239,22,28,19,12,331,14
34206,10,54,108,2,66,5,11,246,7
108502,26,79,131,3,43,1,12,269,190
50749,14,108,213,0,36,5,12,374,54
51184,14,32,199,1,49,10,1,292,55
129872,32,55,2,0,45,0,0,102,240
113318,28,177,84,4,153,3,13,434,201
55399,14,59,155,3,175,6,13,411,47
30019,9,29,66,3,244,12,4,358,289
8038,5,76,113,4,45,13,6,257,247
1072,1,39,100,6,68,15,16,244,3
99370,24,53,211,6,71,8,17,366,171
80563,19,30,317,0,22,6,5,380,117
67840,15,33,71,2,164,18,11,299,81
20326,9,28,115,2,107,9,3,264,285
37210,11,144,137,0,69,5,18,373,19
52720,14,94,184,4,72,12,8,374,41
20070,9,30,97,3,233,24,6,393,274
23864,9,38,92,2,237,24,2,395,300
58537,15,28,308,1,146,19,2,504,94
33427,10,35,37,1,5,0,2,80,6
73142,16,16,139,2,64,3,5,229,103
1760,2,71,48,1,99,4,7,230,130
106634,26,42,107,0,41,6,5,201,186
36708,11,79,302,6,36,9,14,446,18
35102,11,92,268,0,27,6,14,407,15
70896,15,55,84,7,233,20,19,418,89
38584,11,55,57,0,19,4,4,139,9
27029,9,20,50,2,243,4,4,323,281
59782,15,57,117,4,226,19,6,429,58
2268,2,55,160,3,68,23,6,315,131
23252,9,52,134,1,193,19,6,405,299
57327,15,62,132,2,189,18,11,414,90
96232,22,104,136,0,95,11,10,356,164
56734,15,28,44,3,28,1,1,105,68
16358,8,84,154,3,69,12,7,329,267
40586,12,17,7,0,41,3,2,70,22
57922,15,81,93,4,235,30,1,444,92
62199,15,53,111,6,188,11,18,387,64
73388,16,22,137,1,63,4,7,234,103
92209,21,98,133,4,103,3,9,350,160
62715,15,55,83,2,179,23,8,350,65
7517,5,72,104,0,85,9,7,277,246
105363,25,90,71,1,34,1,7,204,183
14308,7,84,28,0,146,0,12,270,255
94724,21,79,75,1,74,1,10,240,152
3035,2,61,161,2,34,5,9,272,133
16066,8,41,106,1,39,4,2,193,267
123738,30,49,79,0,92,6,9,235,219
56127,15,84,104,5,133,3,22,351,57
17638,8,62,169,6,36,10,4,287,270
125619,30,102,105,2,19,0,3,231,224
27366,9,37,76,4,232,14,4,367,282
94384,21,80,104,5,109,8,2,308,151
78341,17,34,103,2,117,16,6,278,112
66927,15,60,89,6,196,6,6,363,77
41599,12,13,20,1,91,0,4,129,24
43283,12,81,48,2,114,2,2,249,27
119027,30,52,127,0,114,5,9,307,228
290,1,89,144,3,46,8,14,304,1
99302,24,99,86,4,27,12,24,252,171
48556,14,69,151,3,20,3,5,251,49
64314,15,73,83,5,177,17,5,360,70
84289,19,53,117,5,25,4,4,208,118
14536,7,120,19,1,105,2,11,258,255
113871,28,95,115,3,93,5,12,323,202
39141,11,55,197,3,69,8,9,341,11
128000,31,117,82,2,52,2,14,269,237
89632,20,79,9,1,76,3,0,168,139
121941,30,41,179,2,93,10,3,328,215
15557,8,38,61,1,19,1,4,124,266
36611,11,66,360,0,43,15,11,495,18
83145,19,91,200,2,70,13,10,386,126
27546,9,19,66,2,228,11,10,336,282
87351,20,190,13,0,183,1,2,389,143
359,1,135,132,7,84,9,12,379,1
714,1,48,166,6,74,24,8,326,2
61371,15,63,119,1,143,17,11,354,62
45351,13,130,33,4,117,1,6,291,32
78817,17,39,93,10,117,19,14,292,113
17199,8,83,70,3,34,2,7,199,269
14666,7,101,144,1,96,2,18,362,256
72908,16,42,29,2,128,2,8,211,102
4074,2,46,174,6,49,20,6,301,135
69922,15,106,97,1,68,1,27,300,86
8733,5,68,174,4,73,12,4,335,249
106823,26,130,101,2,33,3,12,281,186
84655,19,108,166,4,68,15,20,381,119
49455,14,82,168,5,92,18,16,381,51
10395,7,123,16,1,141,1,8,290,253
58939,15,49,146,5,145,15,5,365,95
95134,21,103,51,2,112,3,7,278,153
39036,11,69,122,2,29,4,9,235,10
38934,11,66,160,11,46,4,20,307,10
55623,14,71,236,4,93,12,18,434,48
61160,15,46,108,0,135,10,3,302,61
102278,25,35,40,1,46,2,8,132,178
77527,17,65,133,0,201,20,8,427,110
66932,15,113,87,4,86,16,14,320,77
17871,8,78,328,2,69,7,2,486,270
56930,15,75,98,5,68,2,19,267,79
20404,9,40,135,1,147,10,3,336,285
33599,10,69,25,2,17,0,5,118,6
120459,30,81,65,1,27,1,3,178,231
1491,2,33,103,9,43,4,15,207,129
49802,14,80,183,5,83,17,5,373,52
67979,15,37,61,4,178,18,13,311,81
73106,16,58,132,1,100,8,12,311,103
64520,15,68,75,4,169,16,5,337,71
4861,3,32,52,9,66,3,2,164,210
7101,5,67,141,3,72,7,3,293,245
51162,14,63,265,0,80,16,5,429,55
87122,20,45,76,5,130,12,6,274,142
105653,25,50,58,1,77,5,4,195,184
118245,30,97,173,3,140,15,5,433,226
43094,12,43,40,4,129,6,9,231,27
61649,15,47,154,3,142,9,7,362,63
86598,20,55,18,0,56,2,5,136,141
24938,9,43,210,0,143,20,7,423,277
118585,30,61,143,2,85,6,9,306,227
37400,11,56,177,5,57,12,13,320,20
35876,11,56,192,1,65,5,13,332,16
104672,25,50,178,0,85,10,4,327,182
43410,12,75,1,0,50,0,7,133,27
54346,14,110,126,11,71,9,11,338,45
53025,14,59,162,4,48,8,2,283,42
50240,14,122,293,3,46,6,8,478,53
9630,6,85,152,2,111,7,8,365,251
99582,24,43,228,5,70,9,19,374,172
12573,7,58,87,0,105,2,17,269,261
108365,26,40,200,5,39,4,1,289,190
95251,21,56,30,3,165,8,13,275,153
63679,15,37,108,4,187,22,6,364,69
111760,27,108,7,1,297,0,6,419,198
93031,21,35,139,2,109,10,10,305,163
5561,4,82,125,4,150,8,4,373,242
102275,25,57,74,4,65,2,2,204,178
774,1,56,95,0,82,9,13,255,2
85273,19,153,117,6,115,9,15,415,120
39621,11,62,192,4,47,10,11,326,12
25911,9,27,66,0,348,20,12,473,279
77372,17,42,176,7,136,19,13,393,109
53829,14,177,219,1,31,1,11,440,44
116900,29,48,63,1,144,7,1,264,209
115311,28,86,96,3,104,7,5,301,205
18281,8,64,52,1,79,3,5,204,271
120285,30,67,89,0,132,19,7,314,231
51241,14,67,235,2,74,15,4,397,55
71899,16,57,37,1,71,2,3,171,97
33265,10,95,58,2,61,3,8,227,6
106263,25,31,192,2,96,10,1,332,185
105431,25,38,131,0,74,14,7,264,184
53206,14,92,156,4,61,12,3,328,42
76511,16,50,11,0,163,2,14,240,99
111692,27,40,2,0,23,0,1,66,198
121459,30,56,89,0,144,10,5,304,214
40394,12,21,1,1,49,0,0,72,22
92177,21,80,120,3,113,9,10,335,160
123112,30,41,32,1,13,0,4,91,217
46789,13,143,138,5,130,12,11,439,35
53867,14,108,116,1,72,2,8,307,44
129615,32,8,7,0,26,0,2,43,239
11119,7,32,1,0,192,2,6,233,258
30243,9,52,277,1,158,14,4,506,290
101126,24,36,183,1,70,13,3,306,175
83228,19,58,235,2,66,17,11,389,126
108933,26,60,111,0,211,5,11,398,191
107711,26,138,181,1,22,3,2,347,189
33754,10,83,293,1,101,8,7,493,7
30126,9,14,76,2,374,17,7,490,289
238,1,175,57,6,82,12,12,344,1
101498,24,51,243,5,101,21,7,428,176
62849,15,84,107,1,184,9,16,401,66
23500,9,53,126,2,281,25,15,502,300
124674,30,66,149,0,144,5,21,385,221
126079,30,114,64,2,224,2,26,432,225
7278,5,91,44,0,167,5,3,310,245
110575,27,201,15,2,204,5,9,436,195
89903,20,69,19,0,201,1,10,300,139
78151,17,58,65,7,138,5,6,279,111
108094,26,34,79,2,79,4,5,203,189
87974,20,35,17,0,127,3,15,197,144
115965,29,46,195,2,122,11,9,385,207
24548,9,21,53,1,164,8,4,251,276
95669,21,142,139,5,123,5,12,426,154
62875,15,91,147,22,128,1,20,409,66
92630,21,116,103,0,80,4,7,310,161
129966,32,35,43,3,40,0,15,136,240
17120,8,57,97,4,23,9,8,198,269
91320,21,123,60,0,110,2,11,306,158
95916,21,154,114,0,155,1,4,428,155
20170,9,30,105,3,295,18,7,458,285
87355,20,198,11,3,46,2,8,268,143
70037,15,81,31,4,67,2,5,190,86
83345,19,89,171,6,53,13,2,334,127
5383,3,31,52,0,81,1,9,174,211
48894,14,75,182,0,21,9,5,292,50
17695,8,65,107,2,21,4,8,207,270
77998,17,39,101,2,191,15,13,361,111
84631,19,50,397,2,53,5,3,510,119
33143,10,89,72,3,67,2,8,241,6
21729,9,41,65,0,297,15,9,427,296
60255,15,46,186,4,186,15,3,440,59
117284,30,43,108,1,79,5,13,249,212
45482,13,56,57,8,170,3,8,302,32
4395,2,52,98,0,61,0,6,217,136
57697,15,55,126,1,214,14,6,416,92
53958,14,88,234,5,42,3,2,374,44
117629,30,80,58,5,137,10,15,305,223
130446,32,89,163,9,158,10,23,452,241
122720,30,78,76,1,182,6,14,357,217
112106,28,44,77,3,48,1,9,182,199
63858,15,39,181,1,161,18,4,404,69
113888,28,80,145,1,93,3,11,333,202
118734,30,63,264,1,116,14,2,460,227
105543,25,69,135,2,86,7,9,308,184
93994,21,59,194,2,146,27,6,434,150
105974,25,41,86,2,68,19,4,220,185
22547,9,61,123,1,237,25,6,453,298
34805,11,52,116,1,69,8,9,255,14
86720,20,90,19,0,57,0,14,180,142
8696,5,87,161,5,90,15,13,371,249
68483,15,74,69,4,259,13,3,422,82
107291,26,148,81,0,53,3,4,289,187
120986,30,96,67,0,134,11,12,320,213
25552,9,29,156,4,262,31,7,489,278
120460,30,32,30,0,34,1,3,100,231
5464,4,77,179,5,167,14,13,455,242
51335,14,117,180,5,74,20,14,410,56
92981,21,23,195,1,71,10,2,302,163
82974,19,34,122,4,55,7,7,229,126
36119,11,47,258,1,28,8,10,352,17
22468,9,26,101,1,208,7,3,346,298
53902,14,67,179,5,64,6,11,332,44
27146,9,29,91,5,333,15,10,483,281
96351,22,52,124,0,72,6,12,266,164
37360,11,53,156,2,87,9,10,317,20
56729,15,111,154,3,51,5,11,335,68
117186,30,95,102,0,117,3,15,332,212
65682,15,54,64,3,213,9,8,351,74
96710,22,48,274,0,15,7,15,359,165
96629,22,77,279,1,125,10,11,503,165
126754,31,160,147,0,14,0,7,328,234
23801,9,38,65,0,259,21,7,390,300
62581,15,50,73,3,149,16,10,301,65
91638,21,121,120,2,20,0,7,270,159
66299,15,50,204,0,87,12,5,358,76
64324,15,77,76,7,143,17,5,325,70
23308,9,38,89,2,228,20,9,386,299
69625,15,87,204,13,105,29,9,447,85
1103,1,77,112,4,36,5,7,241,3
87962,20,78,35,1,261,10,9,394,144
61781,15,33,154,1,83,14,9,294,63
120379,30,54,151,0,93,2,12,312,231
10238,7,184,3,0,53,2,12,254,253
76790,16,54,58,0,79,3,1,195,100
82770,19,66,169,9,61,18,1,324,125
110560,27,87,11,0,329,0,6,433,195
59322,15,122,109,9,139,8,16,403,96
35467,11,67,213,5,80,38,9,412,16
47756,13,101,95,4,175,20,6,401,37
12887,7,45,66,1,63,1,0,176,262
105718,25,71,130,2,110,11,9,333,184
30813,9,30,64,2,270,19,10,395,291
44412,12,15,5,5,75,5,2,107,29
59137,15,128,70,6,187,9,12,412,96
107156,26,46,234,0,55,5,5,345,187
47353,13,56,140,10,173,32,17,428,36
88485,20,80,129,0,162,11,7,389,146
82481,19,50,130,5,40,4,3,232,125
90168,21,138,56,2,155,4,19,374,148
98327,23,219,92,4,156,5,6,482,169
50353,14,156,205,4,59,10,6,440,53
114378,28,97,95,3,86,5,7,293,203
22805,9,43,132,1,180,17,4,377,298
22916,9,33,166,2,125,11,3,340,299
92280,21,62,181,1,119,10,0,373,160
22183,9,38,64,4,241,9,1,357,297
48853,14,67,135,2,5,2,4,215,50
117963,30,110,74,3,103,2,19,311,226
19358,8,76,36,5,50,5,24,196,273
109701,27,216,12,2,201,2,11,444,193
839,1,57,183,2,56,12,10,320,3
115645,28,70,165,5,117,11,23,391,206
23979,9,41,392,0,30,3,2,468,275
98795,23,59,41,0,98,5,8,211,170
24082,9,56,205,0,179,0,6,446,275
38689,11,104,137,4,36,1,20,302,10
72119,16,67,123,3,102,6,16,317,101
8000,5,83,99,4,57,5,13,261,247
76866,16,52,47,1,112,4,7,223,100
119041,30,73,133,2,178,12,13,411,228
45972,13,86,27,4,122,3,7,249,33
79801,18,84,159,4,143,9,2,401,115
111202,27,194,1,1,148,0,4,348,197
110360,27,155,9,1,270,1,3,439,195
46874,13,78,65,7,136,4,17,307,35
8669,5,128,45,2,117,6,11,309,248
5027,3,51,76,2,127,8,3,267,210
100371,24,47,91,1,5,7,5,156,173
126925,31,187,120,1,66,4,26,404,234
76932,16,7,35,0,275,1,5,323,100
48081,14,77,106,1,76,6,15,281,38
42786,12,14,22,0,55,0,22,113,26
21121,9,26,102,3,145,8,1,285,294
93167,21,43,237,3,127,21,6,437,163
9982,6,60,46,1,18,1,6,132,252
96513,22,142,217,3,93,4,17,476,164
93011,21,88,166,4,153,32,6,449,163
98895,23,42,116,0,58,14,3,233,170
51422,14,83,199,3,101,23,6,415,56
42146,12,40,94,1,189,12,8,344,25
71841,16,40,39,4,254,6,15,358,97
54849,14,183,34,3,87,1,0,308,46
65413,15,45,76,0,154,11,7,293,73
34508,11,27,167,3,28,0,20,245,8
113083,28,62,162,6,89,5,16,340,201
95451,21,93,73,4,88,5,11,274,154
12828,7,38,35,1,103,2,14,193,262
305,1,31,36,1,4,1,2,75,1
105927,25,2,41,0,18,5,1,67,185
59191,15,128,92,4,129,7,20,380,96
100372,24,58,80,0,9,1,7,155,173
59997,15,71,133,3,158,25,6,396,59
86375,20,88,53,1,262,7,4,415,141
18321,8,38,5,2,3,1,2,51,271
81197,19,125,155,4,63,10,11,368,121
109253,26,30,124,1,103,10,2,270,192
91293,21,82,161,3,60,9,15,330,158
85239,19,94,156,4,30,1,4,289,120
71185,15,87,61,4,210,9,5,376,89
58755,15,33,198,3,161,20,5,420,94
129516,32,80,109,1,75,3,12,280,239
39876,11,9,110,2,72,4,0,197,12
114907,28,100,198,0,20,2,14,334,204
27055,9,26,60,2,276,11,5,380,281
10126,6,72,106,2,56,2,6,244,252
74515,16,83,79,2,164,4,9,341,106
35724,11,87,156,1,14,3,13,274,16
45023,13,170,35,3,87,0,25,320,31
93462,21,49,133,6,159,11,12,370,149
91189,21,71,120,10,125,8,12,346,158
55122,14,31,126,0,36,6,4,203,47
8096,5,102,236,5,70,29,6,448,247
76185,16,53,87,1,57,3,5,206,99
6526,5,54,123,0,26,4,3,210,244
17079,8,108,384,5,209,17,8,731,269
110314,27,102,2,1,238,1,6,350,195
29122,9,66,35,1,247,13,4,366,287
40888,12,55,33,5,181,2,2,278,22
130570,32,89,105,7,88,9,21,319,241
46965,13,92,80,7,168,4,13,364,35
73340,16,53,54,1,115,1,8,232,103
55502,14,105,92,19,97,5,0,318,47
119751,30,69,169,5,64,3,5,315,230
111380,27,198,6,0,132,0,1,337,197
29433,9,31,65,1,310,17,13,437,288
38523,11,35,161,2,39,4,9,250,9
100267,24,104,129,3,37,6,10,289,173
111234,27,83,8,0,394,3,15,503,197
99502,24,41,58,0,12,2,5,118,172
38337,11,41,79,2,53,5,9,189,9
63274,15,36,149,1,140,9,7,342,67
20506,9,19,93,0,201,8,8,329,285
113877,28,125,118,1,94,7,18,363,202
44775,12,62,23,2,91,1,11,190,30
11229,7,118,17,1,134,8,13,291,258
108634,26,50,209,1,138,16,9,423,191
128521,32,59,136,5,164,15,9,388,238
78767,17,72,103,10,121,10,18,334,113
42007,12,53,3,0,113,0,2,171,24
27718,9,22,152,2,187,17,6,386,283
104118,25,70,39,2,42,2,8,163,181
26795,9,113,301,5,317,12,9,757,281
11795,7,61,17,0,171,0,12,261,259
9505,6,122,212,3,80,6,3,426,251
29982,9,30,65,1,319,12,7,434,289
57749,15,57,121,2,122,13,4,319,92
127017,31,140,111,1,11,3,8,274,234
63398,15,73,125,5,213,8,6,430,67
56899,15,133,171,4,142,12,17,479,79
86507,20,20,7,2,36,2,4,71,141
55144,14,77,211,11,69,15,7,390,47
121307,30,72,115,5,165,25,13,395,213
34983,11,88,185,3,28,7,19,330,15
22969,9,28,97,3,170,8,5,311,299
74315,16,33,110,1,214,9,5,372,105
109352,26,84,190,2,89,3,15,383,192
35193,11,59,355,3,30,8,9,464,15
121214,30,55,63,4,139,13,6,280,213
84529,19,30,393,2,44,13,1,483,118
62386,15,58,123,3,218,15,8,425,64
62588,15,48,78,0,230,10,13,379,65
122020,30,83,191,1,48,15,7,345,215
79972,18,71,70,4,93,6,5,249,116
57550,15,108,78,6,210,15,15,432,92
70663,15,77,65,6,200,10,11,369,88
21799,9,21,235,0,144,23,4,427,296
21940,9,22,159,1,109,5,6,302,296
128438,32,45,63,4,34,4,6,156,238
68403,15,57,56,0,176,15,10,314,82
56895,15,216,191,2,126,6,10,551,79
66556,15,61,84,5,101,14,12,277,76
50040,14,98,106,5,53,9,12,283,53
90270,21,92,171,4,34,3,17,321,148
107661,26,20,114,4,22,6,10,176,188
8528,5,100,147,1,106,9,12,375,248
73718,16,59,208,0,121,11,1,400,104
51192,14,59,212,1,58,15,5,350,55
11607,7,149,33,5,160,3,11,361,259
41316,12,15,32,0,19,0,0,66,23
116788,29,23,113,3,176,4,13,332,209
56714,15,128,130,5,66,7,14,350,68
85976,20,117,48,0,84,0,19,268,140
67318,15,46,111,3,224,0,7,391,78
41574,12,61,36,2,149,1,14,263,24
115624,28,78,227,3,97,15,27,447,206
10131,6,158,174,0,71,4,6,413,252
44554,12,40,52,1,160,8,11,272,30
4839,3,34,37,0,62,7,7,147,210
48890,14,91,251,2,18,8,13,383,50
32907,10,74,109,0,79,6,7,275,5
59348,15,82,36,3,26,3,18,168,96
124178,30,111,69,2,138,3,5,328,220
102938,25,31,112,6,91,6,4,250,179
63584,15,47,122,3,163,12,8,355,67
127709,31,94,172,3,40,7,16,332,236
57063,15,49,26,4,164,7,5,255,79
106205,25,30,44,1,82,8,6,171,185
72465,16,6,90,0,106,3,4,209,101
129309,32,5,23,1,5,1,1,36,239
113542,28,62,134,3,78,7,7,291,202
119699,30,73,176,6,103,5,9,372,230
67727,15,54,86,3,256,15,1,415,80
1653,2,64,102,2,48,7,6,229,130
69411,15,88,115,5,134,9,7,358,85
64395,15,41,252,2,93,8,3,399,71
16972,8,56,126,7,29,9,5,232,269
56599,15,80,135,13,175,19,15,437,68
121553,30,75,73,1,222,14,6,391,214
90764,21,75,106,5,105,9,16,316,156
69370,15,80,86,4,148,13,10,341,85
121440,30,91,162,0,197,10,4,464,214
125342,30,95,49,4,126,5,26,305,222
108132,26,60,208,4,57,6,15,350,190
109820,27,90,25,1,328,4,3,451,194
28737,9,35,95,2,210,22,5,369,286
39886,11,19,102,5,86,5,1,218,12
51584,14,86,158,2,97,11,7,361,56
88351,20,173,33,2,156,1,13,378,145
125458,30,43,89,1,141,4,10,288,224
4127,2,59,82,5,54,5,14,219,135
110098,27,254,15,0,214,4,12,499,194
6505,5,77,155,2,36,8,4,282,244
117598,30,189,38,1,67,0,15,310,223
121586,30,66,50,0,120,6,3,245,214
31703,9,28,93,4,213,19,6,363,293
62302,15,43,92,3,143,13,17,311,64
14505,7,99,11,1,120,3,14,248,255
33324,10,35,5,1,4,0,1,46,6
100602,24,53,114,4,50,6,11,238,174
64600,15,60,110,1,175,13,8,367,71
36311,11,76,243,2,27,9,12,369,17
119326,30,67,111,1,156,5,6,346,229
61015,15,33,75,3,161,9,7,288,61
18475,8,82,59,2,2,1,4,150,271
109946,27,96,4,1,303,3,8,415,194
45285,13,91,60,8,47,1,5,212,32
123686,30,98,140,2,153,10,11,414,219
43053,12,75,128,3,97,5,9,317,27
126055,30,81,57,0,183,3,7,331,225
66075,15,106,183,6,94,9,18,416,75
28647,9,32,74,4,153,10,5,278,286
85921,20,234,3,1,168,3,20,429,140
9910,6,145,53,2,76,1,8,285,252
12153,7,104,52,2,94,15,25,292,260
11670,7,55,43,0,88,0,13,199,259
83339,19,105,248,8,82,15,7,465,127
35602,11,68,114,3,69,23,5,282,16
46553,13,35,88,1,148,10,7,289,34
121604,30,46,44,1,122,1,2,216,214
108491,26,44,112,6,44,1,12,219,190
45270,13,110,67,6,180,3,20,386,32
107633,26,4,16,0,8,0,3,31,188
16877,8,106,165,0,45,4,12,332,269
128328,31,109,158,1,45,7,10,330,237
57455,15,88,112,9,72,16,18,315,90
98652,23,53,43,2,123,10,9,240,170
93218,21,81,167,4,135,14,10,411,163
28085,9,23,50,7,203,10,7,300,283
39427,11,89,249,1,19,8,16,382,11
119236,30,105,77,1,110,2,10,305,229
24723,9,33,107,4,351,27,2,524,276
103182,25,55,75,0,42,1,5,178,179
86773,20,34,23,0,55,2,4,118,142
66121,15,120,97,4,94,5,8,328,75
21287,9,30,83,4,319,14,8,458,295
117344,30,161,162,0,54,2,5,384,212
18597,8,60,66,4,80,11,11,232,271
109615,27,100,4,1,243,1,9,358,193
16303,8,64,152,1,36,10,4,267,267
61573,15,33,298,1,42,8,4,386,63
112121,28,61,125,5,60,11,3,265,199
72412,16,23,64,2,47,1,11,148,101
114310,28,78,88,3,95,3,8,275,203
19316,8,67,16,1,9,3,7,103,273
12208,7,93,31,0,73,0,11,208,260
67398,15,66,78,3,175,18,7,347,80
3027,2,47,133,4,47,7,3,241,133
123046,30,80,47,1,138,1,5,272,217
55001,14,70,191,1,57,7,6,332,46
78096,17,48,136,3,71,5,11,274,111
38463,11,123,52,1,42,3,28,249,9
117947,30,98,104,6,125,6,2,341,226
83683,19,75,206,3,57,14,8,363,127
111428,27,205,16,0,323,4,1,549,198
53386,14,35,179,1,47,10,5,277,43
36679,11,69,299,1,53,18,6,446,18
51666,14,71,191,6,54,13,7,342,39
43357,12,96,31,1,109,3,8,248,27
60935,15,24,95,0,215,16,11,361,61
59885,15,22,69,0,136,18,3,248,58
69760,15,54,108,1,121,8,4,296,86
82135,19,162,119,8,69,11,22,391,124
82433,19,120,73,4,39,5,18,259,124
104470,25,35,100,2,101,3,4,245,182
114857,28,116,125,9,53,1,5,309,204
130507,32,73,57,4,88,2,18,242,241
94917,21,166,15,2,128,4,4,319,152
121718,30,9,16,0,32,3,0,60,214
4088,2,55,184,0,78,9,5,331,135
94457,21,39,140,3,102,11,7,302,151
94635,21,52,218,2,143,16,10,441,152
124655,30,117,121,0,93,3,4,338,221
117168,30,86,103,3,143,3,14,352,212
23676,9,27,95,2,168,9,2,303,300
63656,15,53,175,4,146,17,5,400,67
127624,31,74,271,1,65,20,5,436,236
38458,11,18,143,2,37,11,11,222,9
127764,31,91,157,1,72,11,6,338,236
73995,16,76,147,0,132,10,12,377,105
93860,21,61,202,3,131,12,7,416,150
48920,14,23,166,0,11,1,6,207,50
122578,30,74,174,4,121,8,15,396,216
37362,11,43,178,1,67,9,1,299,20
114821,28,18,23,3,11,1,2,58,204
30332,9,49,144,2,172,8,3,378,290
64066,15,39,376,2,65,14,8,504,70
111480,27,125,42,1,260,7,6,441,198
69400,15,111,98,2,112,5,11,339,85
88119,20,198,2,0,248,1,6,455,145
81933,19,86,180,3,40,11,12,332,123
97095,22,50,272,3,97,14,1,437,166
60907,15,40,73,7,208,19,10,357,61
40488,12,14,3,0,47,0,1,65,22
19461,8,68,148,4,38,5,6,269,273
51787,14,69,324,5,77,22,5,502,39
65948,15,79,265,7,83,26,16,476,75
51631,14,78,279,3,108,21,5,494,56
46213,13,67,77,7,179,9,10,349,33
12049,7,107,76,2,125,10,10,330,260
129112,32,30,87,10,95,19,6,247,239
38886,11,50,172,0,37,2,10,271,10
106729,26,53,114,1,42,9,6,225,186
39035,11,28,111,1,68,0,8,216,10
7136,5,60,56,1,35,3,2,157,245
85895,20,63,91,0,123,1,11,289,137
59758,15,55,84,2,189,9,9,348,58
70136,15,175,38,3,51,5,18,290,86
39415,11,42,132,17,59,4,21,275,11
112037,28,80,144,3,69,13,7,316,199
10033,6,108,184,2,128,11,4,437,252
97542,22,71,247,2,128,17,14,479,167
71752,16,47,96,1,227,17,5,393,97
40879,12,43,20,2,126,2,1,194,22
42290,12,42,41,2,149,2,5,241,25
113193,28,78,96,4,148,21,4,351,201
15981,8,62,135,2,71,9,4,283,267
65697,15,56,73,4,228,11,7,379,74
41497,12,77,91,2,34,1,11,216,23
73457,16,47,187,2,57,6,12,311,104
119344,30,88,85,0,179,5,14,371,229
12924,7,56,68,4,123,4,14,269,262
73811,16,30,241,2,79,5,1,358,104
85203,19,150,92,9,138,6,12,407,120
3328,2,70,117,4,58,9,13,271,133
14681,7,62,95,2,80,1,18,258,256
86703,20,31,25,2,144,2,2,206,141
28142,9,43,66,0,231,8,6,354,284
105039,25,64,52,1,33,2,0,152,183
116130,29,7,19,0,20,0,2,48,207
13524,7,71,59,1,125,3,3,262,264
85484,19,151,111,20,47,4,17,350,120
61028,15,55,75,5,190,11,5,341,61
80122,18,144,239,3,226,17,5,634,116
124155,30,59,81,0,63,7,6,216,220
80107,18,106,126,3,124,9,4,372,116
89589,20,122,57,0,110,5,24,318,138
77946,17,46,120,11,188,23,28,416,111
18434,8,78,109,2,25,2,8,224,271
109389,26,46,88,0,70,1,5,210,192
100706,24,92,112,6,61,8,51,330,174
77291,17,52,138,6,126,15,5,342,109
56338,15,177,67,6,117,5,32,404,57
11408,7,37,9,2,52,0,7,107,258
25605,9,30,129,1,227,15,7,409,278
3304,2,73,88,2,47,6,7,223,133
37225,11,40,169,1,52,10,8,280,19
95160,21,100,121,1,48,0,19,289,153
90293,21,129,58,1,23,1,5,217,148
47595,13,87,143,3,86,2,14,335,37
118872,30,67,164,3,125,6,16,381,228
117821,30,148,162,0,56,0,8,374,223
71527,15,80,199,5,92,12,22,410,91
49557,14,130,122,9,65,13,20,359,51
92941,21,54,117,4,124,11,18,328,162
50015,14,70,46,8,73,10,10,217,52
53430,14,72,158,5,51,9,12,307,43
94701,21,59,181,7,141,11,7,406,152
31881,9,44,70,4,285,24,6,433,293
96883,22,70,205,1,61,3,29,369,165
105690,25,80,145,9,142,11,13,400,184
17523,8,119,247,8,41,11,11,437,270
46967,13,66,51,5,172,6,3,303,35
57053,15,112,38,9,171,8,23,361,79
59063,15,33,82,1,164,9,6,295,95
117546,30,54,119,2,175,2,15,367,223
45806,13,71,123,3,145,6,14,362,33
130013,32,145,13,1,259,1,11,430,240
69541,15,32,14,2,28,0,2,78,85
19754,8,72,29,8,6,0,2,117,273
112948,28,102,187,4,75,6,13,387,201
103830,25,126,179,2,73,5,12,397,180
53938,14,75,68,7,138,3,11,302,44
60979,15,36,110,6,166,14,7,339,61
80529,19,56,425,3,36,6,2,528,117
28355,9,23,46,0,234,10,7,320,284
48806,14,122,202,2,26,12,9,373,50
114967,28,103,132,2,99,6,26,368,205
112195,28,75,90,3,38,3,12,221,199
82378,19,106,107,1,48,6,13,281,124
21246,9,25,73,2,251,15,4,370,295
41203,12,26,10,1,39,0,1,77,23
42854,12,85,30,6,163,5,10,299,26
109271,26,24,153,3,114,4,8,306,192
40811,12,28,1,0,52,1,1,83,22
44808,12,37,34,0,113,1,13,198,30
97839,22,59,78,0,68,7,8,220,167
3810,2,93,176,6,77,10,7,369,134
46220,13,103,71,0,82,1,6,263,33
71346,15,87,77,2,94,4,4,268,91
125478,30,71,74,1,109,0,10,265,224
28146,9,56,85,4,300,17,4,466,284
60137,15,64,144,2,169,33,3,415,59
13200,7,59,4,1,153,0,14,231,263
31019,9,25,38,5,274,11,10,363,291
78752,17,46,30,7,151,5,15,254,113
128864,32,78,43,3,112,4,20,260,238
18299,8,78,60,7,45,8,7,205,271
84798,19,156,138,7,54,9,10,374,119
114716,28,49,113,6,113,8,6,295,204
13314,7,41,3,6,9,0,3,62,263
47114,13,65,161,15,147,24,6,418,36
74674,16,71,125,0,57,3,6,262,106
87271,20,124,86,1,182,9,6,408,143
115340,28,84,100,3,97,11,4,299,205
14357,7,49,92,1,102,1,6,251,255
97117,22,55,202,6,116,14,2,395,166
62207,15,60,155,2,191,21,23,452,64
85193,19,90,118,15,57,4,10,294,120
116683,29,74,101,7,216,7,19,424,209
98606,23,114,74,0,119,5,16,328,169
117134,30,27,57,0,33,1,9,127,212
5127,3,43,69,0,88,17,11,228,211
65822,15,63,50,2,199,13,16,343,74
40144,11,47,67,1,45,2,19,181,13
118164,30,74,126,4,106,6,13,329,226
112464,28,85,108,2,54,2,10,261,200
8637,5,103,90,1,43,2,13,252,248
49185,14,89,271,2,38,4,12,416,50
127238,31,83,161,2,50,10,10,316,235
70474,15,70,123,8,232,25,17,475,87
117282,30,40,101,4,70,7,24,246,212
16598,8,65,94,3,35,12,5,214,268
126959,31,147,145,3,37,6,14,352,234
68662,15,70,51,3,194,12,21,351,83
36190,11,68,264,1,37,13,9,392,17
65504,15,83,49,5,128,17,13,295,74
58618,15,53,116,5,166,29,7,376,94
97522,22,107,127,3,98,6,24,365,167
94163,21,78,196,4,146,14,18,456,150
8201,5,61,112,2,105,4,6,290,248
92883,21,66,63,0,220,2,9,360,162
99833,24,45,220,2,29,4,26,326,172
57352,15,92,174,3,157,24,12,462,90
17585,8,89,185,6,44,5,10,339,270
89132,20,55,76,0,191,10,6,338,147
89573,20,27,41,0,80,2,29,179,138
62185,15,71,70,3,171,19,13,347,64
105389,25,23,61,0,15,1,7,107,183
29578,9,26,30,0,313,7,10,386,288
60254,15,50,145,4,164,25,4,392,59
81092,19,154,59,3,44,5,17,282,121
22874,9,20,110,3,154,14,1,302,298
92520,21,83,120,1,160,1,3,368,161
103940,25,23,104,0,32,3,2,164,181
80195,18,55,44,0,47,2,7,155,116
75522,16,49,198,3,104,7,6,367,108
17082,8,84,195,1,20,1,3,304,269
63196,15,73,149,2,187,18,7,436,66
86297,20,72,85,0,199,10,6,372,141
9055,5,91,128,4,153,9,17,402,249
11025,7,33,11,1,25,3,3,76,257
77945,17,50,99,5,141,13,11,319,111
79619,18,77,38,6,141,14,8,284,115
73603,16,6,39,0,151,0,5,201,104
95444,21,111,130,1,144,13,14,413,154
59336,15,98,60,3,109,8,19,297,96
35064,11,54,314,2,47,18,4,439,15
1667,2,110,294,3,67,13,1,488,130
32092,10,54,115,4,41,4,10,228,4
129486,32,10,11,0,32,0,0,53,239
50844,14,78,125,7,86,10,5,311,55
82283,19,169,53,2,67,5,23,319,124
6192,4,104,82,7,113,12,6,324,243
27678,9,29,104,4,332,25,9,503,282
46441,13,67,61,4,91,10,9,242,34
107906,26,95,139,1,99,22,8,364,189
100278,24,52,51,0,5,0,9,117,173
33660,10,43,30,4,6,1,3,87,6
66248,15,117,155,2,116,9,15,414,76
61729,15,26,310,3,116,17,9,481,63
78235,17,42,59,8,139,5,10,263,111
72819,16,78,90,5,78,11,19,281,102
125810,30,98,69,1,100,5,10,283,224
130767,32,187,60,4,118,3,24,396,241
61390,15,66,147,2,168,17,20,420,62
7276,5,103,6,3,132,3,8,255,245
87854,20,215,15,2,115,2,30,379,144
114939,28,125,206,13,82,2,23,451,205
34747,11,18,146,1,41,9,10,225,14
128989,32,84,55,4,79,3,9,234,239
42905,12,1,0,0,39,0,2,42,26
103582,25,86,116,1,108,4,3,318,180
50640,14,121,159,15,89,13,6,403,54
77938,17,52,82,2,154,16,10,316,111
96244,22,58,65,2,37,4,15,181,164
106169,25,53,85,1,70,7,7,223,185
113957,28,119,146,2,111,2,14,394,203
44446,12,42,47,2,115,4,12,222,30
32923,10,63,109,1,78,7,6,264,5
42909,12,134,83,1,79,3,9,309,26
96402,22,104,121,3,76,5,21,330,164
30167,9,12,126,0,156,18,2,314,289
113316,28,83,57,6,109,0,3,258,201
124738,30,77,51,6,101,1,8,244,221
61275,15,30,383,1,44,3,1,462,62
56717,15,87,163,2,57,6,15,330,68
77439,17,73,146,4,157,12,8,400,109
8057,5,130,159,3,80,18,9,399,247
25191,9,45,119,1,190,19,3,377,277
116797,29,53,175,2,147,6,16,399,209
6808,5,106,62,3,48,3,12,234,245
95917,21,103,106,5,208,3,9,434,155
77587,17,86,81,3,180,12,7,369,110
98214,23,133,68,1,158,3,10,373,168
40185,11,55,275,3,87,6,8,434,13
61448,15,59,220,4,139,19,2,443,62
76610,16,72,28,1,146,6,8,261,100
38353,11,35,80,3,109,5,1,233,9
110350,27,244,6,0,264,0,7,521,195
85927,20,152,65,1,138,4,13,373,140
10262,7,194,3,0,110,0,12,319,253
23995,9,44,169,4,241,6,7,471,275
75497,16,36,139,1,97,11,14,298,108
34605,11,18,151,3,69,15,8,264,14
38060,11,73,146,3,39,0,20,281,21
126860,31,111,170,3,73,7,10,374,234
71367,15,75,162,3,96,13,13,362,91
82643,19,63,218,4,58,13,13,369,125
103922,25,48,99,0,26,3,1,177,181
69312,15,83,155,5,102,14,11,370,84
88094,20,139,13,1,281,0,4,438,145
61472,15,46,146,4,189,16,11,412,62
64325,15,39,123,6,153,16,6,343,70
67086,15,61,57,1,180,11,4,314,78
49442,14,72,249,5,127,30,5,488,51
79483,18,58,24,2,129,0,7,220,114
58333,15,76,139,7,237,26,10,495,93
65300,15,45,161,3,147,13,10,379,73
66519,15,32,213,2,133,17,0,397,76
110983,27,184,14,0,173,2,6,379,196
77011,17,48,147,6,184,13,5,403,109
101973,24,57,124,2,82,5,12,282,177
20858,9,21,84,1,191,16,14,327,294
40063,11,43,41,4,183,3,16,290,13
76808,16,47,47,2,112,6,6,220,100
100641,24,69,95,0,117,3,12,296,174
32643,10,111,176,3,70,10,8,378,5
90950,21,53,137,0,74,5,15,284,157
98726,23,48,83,3,164,5,7,310,170
56130,15,80,164,3,118,7,16,388,57
102932,25,75,105,1,77,6,0,264,179
36015,11,31,351,2,44,10,5,443,17
68557,15,76,76,2,185,10,16,365,83
116423,29,44,158,1,120,5,18,346,208
104368,25,68,120,4,97,6,9,304,182
42713,12,24,12,0,151,2,9,198,26
105926,25,148,138,0,44,0,10,340,184
96781,22,36,212,7,172,24,2,453,165
120069,30,83,58,0,123,3,1,268,231
20266,9,28,108,3,135,12,4,290,285
98783,23,42,104,0,116,11,9,282,170
14653,7,128,49,1,142,1,19,340,256
119923,30,95,46,2,64,1,12,220,230
25461,9,38,66,2,324,12,10,452,278
14691,7,72,68,1,102,6,39,288,256
48801,14,123,240,2,30,8,14,417,50
29716,9,28,39,5,292,7,11,382,288
121123,30,67,121,2,148,20,2,360,213
41958,12,52,28,0,162,3,4,249,24
77821,17,52,77,1,94,11,11,246,110
36257,11,91,262,5,44,13,13,428,17
29542,9,36,50,2,222,9,8,327,288
26921,9,23,95,0,175,18,4,315,281
48565,14,251,98,1,52,5,24,431,49
102530,25,17,29,0,22,0,1,69,178
27524,9,25,155,1,283,1,6,471,282
84973,19,81,190,13,65,8,15,372,119
128693,32,33,98,3,104,9,27,274,238
103199,25,124,40,4,79,3,12,262,179
54504,14,68,216,4,80,16,10,394,45
36814,11,74,339,2,31,14,10,470,18
109991,27,46,7,0,252,0,7,312,194
45149,13,138,44,5,39,1,15,242,31
43733,12,88,69,6,156,13,6,338,28
72237,16,92,71,0,141,2,2,308,101
125183,30,63,104,3,122,10,4,306,222
88955,20,55,73,1,186,13,5,333,147
110260,27,199,12,1,232,2,5,451,195
101931,24,61,7,0,136,1,31,236,177
9340,5,100,175,4,73,15,9,376,250
23267,9,30,90,4,222,18,1,365,299
119151,30,53,134,0,140,6,0,333,228
117481,30,30,58,1,98,4,19,210,223
32862,10,59,38,5,164,1,6,273,5
97382,22,27,121,4,73,8,8,241,166
65618,15,68,115,6,110,17,6,322,74
40274,11,73,135,15,104,14,9,350,13
23145,9,49,118,0,279,19,7,472,299
59070,15,58,151,3,167,22,10,411,95
25706,9,29,74,0,214,13,3,333,278
29259,9,45,142,0,358,25,5,575,287
13100,7,72,62,1,96,12,12,255,263
90798,21,25,50,2,34,1,11,123,157
11422,7,48,20,1,51,0,6,126,258
14639,7,94,44,0,170,4,9,321,255
107487,26,42,176,5,60,12,11,306,188
107721,26,104,255,5,24,2,7,397,189
98714,23,74,87,2,193,5,13,374,170
81516,19,47,227,4,72,13,10,373,122
98166,23,90,66,1,123,4,8,292,168
36917,11,40,130,25,76,7,6,284,19
56543,15,63,122,3,188,16,11,403,68
21177,9,21,42,5,295,14,4,381,295
38536,11,95,85,1,56,2,12,251,9
11059,7,292,30,0,46,2,16,386,258
94488,21,72,164,5,148,18,16,423,151
96823,22,42,187,8,149,14,27,427,165
101433,24,43,243,3,90,24,11,414,176
104183,25,81,64,7,112,1,12,277,181
87882,20,67,19,4,174,4,19,287,144
71005,15,69,61,2,241,19,10,402,89
102498,25,111,84,1,45,1,6,248,178
16851,8,107,77,5,72,9,3,273,268
43808,12,89,35,9,91,2,2,228,28
80421,18,81,32,2,168,8,7,298,116
52813,14,91,128,4,38,15,16,292,41
128807,32,96,32,2,88,4,8,230,238
23797,9,41,165,2,228,25,6,467,300
64697,15,85,165,3,195,16,9,473,71
41367,12,21,15,0,12,0,0,48,23
18926,8,88,240,1,62,8,22,421,272
102365,25,59,63,0,50,3,2,177,178
4571,2,60,85,5,78,8,2,238,136
1323,2,34,141,3,68,13,7,266,129
123870,30,84,52,2,5,2,4,149,219
54816,14,79,124,4,130,19,13,369,46
62686,15,28,97,1,154,14,3,297,65
69783,15,49,125,1,100,4,10,289,86
98642,23,28,81,0,126,6,10,251,170
121859,30,40,162,2,89,8,10,311,215
25276,9,40,70,3,249,11,7,380,277
6981,5,124,122,4,33,6,13,302,245
72861,16,80,87,3,120,4,17,311,102
116813,29,51,155,3,129,10,23,371,209
80438,18,97,62,1,30,1,0,191,116
115508,28,60,159,2,62,9,20,312,206
129807,32,22,108,1,59,5,2,197,240
37258,11,35,102,2,31,1,6,177,19
126045,30,84,78,0,143,5,6,316,225
60129,15,46,95,6,177,13,10,347,59
118536,30,123,120,0,82,10,7,342,227
124040,30,71,159,4,126,2,10,372,219
73894,16,61,64,2,184,7,19,337,105
83455,19,135,88,2,30,9,19,283,127
113113,28,69,85,3,143,3,14,317,201
29698,9,23,24,0,265,7,4,323,288
26309,9,35,148,9,130,9,11,342,280
28896,9,41,269,2,143,10,7,472,286
57793,15,87,230,3,105,17,10,452,92
71493,15,51,156,9,100,4,18,338,91
69825,15,36,34,2,104,1,8,185,86
1813,2,87,113,1,69,7,14,291,130
53164,14,90,146,2,85,23,12,358,42
77537,17,57,148,1,190,15,7,418,110
7984,5,77,199,4,70,18,7,375,247
33494,10,28,101,1,21,2,6,159,6
76539,16,48,49,0,90,2,6,195,99
82320,19,118,153,6,60,11,11,359,124
43647,12,85,75,4,188,9,14,375,28
45857,13,120,43,1,191,4,10,369,33
4334,2,78,68,4,50,7,14,221,135
70457,15,54,124,3,198,31,13,423,87
107377,26,46,178,6,47,7,6,290,188
13522,7,60,67,0,157,2,16,302,264
111225,27,170,6,1,271,0,5,453,197
50506,14,123,150,5,90,14,14,396,54
121293,30,44,158,1,90,5,8,306,213
98727,23,58,64,3,160,5,12,302,170
86917,20,68,67,3,195,8,5,346,142
34117,10,82,203,4,74,18,12,393,7
78964,17,46,55,1,127,8,10,247,113
58036,15,40,164,4,210,28,5,451,93
49496,14,147,132,8,74,11,12,384,51
68542,15,86,48,5,151,11,19,320,83
97174,22,63,269,3,89,17,4,445,166
109295,26,44,219,3,117,10,3,396,192
48150,14,66,166,2,35,2,2,273,38
71257,15,87,92,8,62,3,9,261,91
20099,9,19,120,1,137,12,3,292,274
22270,9,31,59,2,279,11,9,391,297
69943,15,97,106,6,102,6,11,328,86
26318,9,25,203,0,115,20,5,368,280
36659,11,55,307,3,57,11,10,443,18
41840,12,95,59,1,184,5,6,350,24
67103,15,39,53,2,135,14,3,246,78
124295,30,80,138,0,68,7,4,297,220
14345,7,37,31,2,153,0,40,263,255
16662,8,74,89,4,55,10,6,238,268
15171,8,116,51,5,60,7,10,249,265
119257,30,193,109,0,136,1,8,447,229
76465,16,131,28,2,84,7,7,259,99
101601,24,27,176,2,66,9,4,284,176
75881,16,37,193,1,182,11,11,435,98
27401,9,24,77,4,259,23,19,406,282
62387,15,60,93,6,166,13,7,345,64
53573,14,118,197,10,88,11,17,441,43
9590,6,96,166,2,110,12,8,394,251
122282,30,69,88,0,81,16,7,261,216
60316,15,48,47,4,211,13,3,326,60
87065,20,57,33,1,192,2,23,308,142
48508,14,72,172,1,11,1,10,267,49
49444,14,85,209,5,94,17,19,429,51
114225,28,115,135,6,111,6,9,382,203
26035,9,36,52,4,248,22,7,369,279
54843,14,73,67,1,124,2,10,277,46
54588,14,146,105,5,92,7,9,364,45
44447,12,43,30,1,135,1,7,217,30
5581,4,69,104,4,142,8,9,336,242
44345,12,76,8,2,122,0,6,214,29
61632,15,41,220,5,106,10,4,386,63
71361,15,74,172,4,73,8,5,336,91
18295,8,159,92,4,40,3,12,310,271
48441,14,79,266,6,50,9,17,427,49
96283,22,91,217,1,131,18,9,467,164
129651,32,50,79,3,27,4,14,177,239
88444,20,84,109,4,271,14,15,497,146
113569,28,79,128,4,60,6,2,279,202
113237,28,85,71,6,98,7,11,278,201
38954,11,30,225,1,25,5,12,298,10
118314,30,39,111,2,98,8,13,271,226
67975,15,43,61,5,244,17,15,385,81
107967,26,33,78,3,122,3,3,242,189
58977,15,74,87,8,231,15,16,431,95
54614,14,124,64,5,113,39,20,365,46
21603,9,27,111,2,266,12,10,428,296
66470,15,58,129,6,96,19,12,320,76
36933,11,36,154,9,44,1,16,260,19
77832,17,60,98,6,129,8,15,316,110
105133,25,45,111,0,67,0,12,235,183
5839,4,30,58,83,31,1,6,209,242
108739,26,47,202,3,143,27,14,436,191
67734,15,47,58,1,240,24,1,371,80
15323,8,65,137,5,41,8,2,258,265
49198,14,43,166,1,18,1,3,232,50
47555,13,71,128,3,97,12,5,316,37
92920,21,76,198,1,18,3,5,301,162
9159,5,85,313,5,49,25,8,485,250
19895,9,20,88,2,283,10,4,407,274
2321,2,58,168,4,85,19,5,339,131
24670,9,36,84,1,201,10,3,335,276
81101,19,197,70,5,30,4,17,323,121
93673,21,17,91,2,91,6,12,219,149
81274,19,112,137,6,61,12,11,339,122
8699,5,40,147,8,94,17,1,307,249
90617,21,140,90,1,45,7,33,316,156
91298,21,92,40,8,47,1,18,206,158
56039,15,119,125,2,110,9,21,386,57
26893,9,25,101,2,179,19,4,330,281
107789,26,81,179,0,14,5,5,284,189
69487,15,50,49,1,198,5,14,317,85
55157,14,82,122,5,52,17,8,286,47
23455,9,42,129,3,280,22,9,485,300
95224,21,79,67,0,117,2,5,270,153
23637,9,45,84,4,256,18,8,415,300
124326,30,68,141,3,83,7,15,317,220
120713,30,71,175,1,57,3,20,327,232
6907,5,65,105,2,112,10,6,300,245
103419,25,39,21,0,134,1,1,196,180
65584,15,54,56,3,177,12,20,322,74
123787,30,77,151,1,154,22,19,424,219
26563,9,49,177,2,271,19,7,525,280
16503,8,57,81,5,31,8,6,188,268
125102,30,47,103,6,74,1,20,251,222
62323,15,74,119,8,180,15,13,409,64
36202,11,63,260,4,32,8,10,377,17
41902,12,63,31,3,285,8,6,396,24
42107,12,49,56,2,166,5,10,288,25
89326,20,144,35,2,156,1,22,360,138
37742,11,61,177,2,24,10,15,289,20
26403,9,37,231,1,84,8,6,367,280
99978,24,92,79,1,13,1,18,204,173
10915,7,0,0,0,648,0,9,657,257
103984,25,63,93,5,129,4,9,303,181
29291,9,33,63,2,290,14,3,405,287
108665,26,46,146,0,81,11,5,289,191
29857,9,19,50,2,243,8,8,330,289
124960,30,102,30,2,45,2,15,196,221
8122,5,93,102,4,69,8,9,285,247
112461,28,48,136,4,75,8,5,276,200
87025,20,43,58,2,26,0,7,136,142
35875,11,65,192,0,51,1,23,332,16
98218,23,94,38,0,178,7,6,323,168
8586,5,69,119,1,58,8,4,259,248
120739,30,82,123,6,137,9,19,376,232
12339,7,167,11,0,145,0,14,337,261
17609,8,66,119,4,23,12,9,233,270
22775,9,46,107,5,228,18,3,407,298
118259,30,61,145,2,99,12,11,330,226
67882,15,33,54,0,189,10,2,288,81
94829,21,93,72,5,51,1,16,238,152
60767,15,45,93,2,142,16,9,307,61
63064,15,72,165,3,197,9,14,460,66
29723,9,23,47,1,298,21,13,403,288
25003,9,29,60,4,200,2,8,303,277
48298,14,34,108,3,43,0,10,198,38
12250,7,209,117,2,98,1,25,452,260
109591,27,128,4,1,231,2,5,371,193
70639,15,49,104,4,159,24,3,343,88
74947,16,43,114,2,132,11,11,313,107
8346,5,87,73,2,42,9,6,219,248
84870,19,98,203,4,63,14,15,397,119
130591,32,33,82,4,99,4,18,240,241
8504,5,83,78,2,83,8,9,263,248
94015,21,42,194,3,97,18,4,358,150
100737,24,139,101,1,72,6,15,334,174
10147,6,140,88,1,63,7,3,302,252
36676,11,67,290,1,66,16,3,443,18
97711,22,100,270,3,125,26,11,535,167
116378,29,51,102,5,190,15,12,375,208
72031,16,194,22,0,128,1,3,348,101
488,1,126,160,8,93,16,17,420,2
112194,28,70,137,2,44,9,4,266,199
104322,25,216,31,3,218,0,9,477,181
32063,10,50,104,7,43,7,23,234,4
34113,10,102,241,3,86,13,9,454,7
54621,14,155,206,1,49,5,14,430,46
118916,30,82,181,1,178,14,10,466,228
130409,32,60,72,7,79,1,15,234,241
81441,19,73,219,6,66,14,9,387,122
73385,16,5,24,1,27,0,0,57,103
29457,9,18,42,3,229,14,5,311,288
21751,9,26,167,3,226,18,7,447,296
76271,16,77,45,3,131,9,8,273,99
74274,16,40,113,2,106,5,7,273,105
85212,19,148,104,16,117,4,16,405,120
42162,12,83,138,5,196,18,8,448,25
42659,12,11,2,0,170,0,0,183,26
35030,11,72,231,2,27,0,12,344,15
120888,30,126,88,7,177,6,13,417,232
88349,20,130,71,0,156,0,0,357,145
42399,12,53,28,1,226,6,4,318,25
59612,15,39,118,3,184,18,18,380,58
56959,15,80,129,2,93,2,21,327,79
9656,6,144,43,0,50,1,15,253,251
25414,9,52,140,1,309,21,9,532,278
105180,25,60,128,2,145,10,8,353,183
49633,14,115,144,0,20,3,4,286,52
89572,20,63,97,4,45,3,36,248,138
60660,15,26,49,3,153,10,2,243,60
14800,7,80,111,2,189,17,3,402,256
58253,15,39,56,5,179,11,9,299,93
80892,19,127,80,5,65,3,9,289,121
50594,14,85,132,2,56,10,4,289,54
109010,26,59,96,0,103,0,7,265,192
40578,12,44,34,0,8,0,1,87,22
95008,21,33,50,2,98,2,6,191,153
63939,15,52,62,4,179,15,5,317,69
66164,15,86,150,5,110,14,16,381,75
113026,28,42,162,2,104,4,7,321,201
73246,16,35,155,2,41,2,1,236,103
52312,14,109,157,5,163,26,16,476,40
36801,11,52,235,3,18,5,9,322,18
18617,8,63,120,4,59,8,7,261,271
52958,14,69,125,1,61,10,2,268,42
24726,9,51,73,3,307,11,6,451,276
123649,30,110,158,0,127,9,10,414,219
14324,7,82,43,3,98,1,11,238,255
4774,2,49,104,3,92,8,5,261,136
120421,30,64,79,3,119,11,4,280,231
43097,12,72,37,4,192,7,1,313,27
59067,15,62,85,0,149,15,9,320,95
127291,31,95,171,0,68,13,13,360,235
4051,2,50,152,3,38,12,6,261,135
86185,20,116,18,0,130,4,28,296,140
121061,30,84,133,2,163,17,13,412,213
97844,22,23,118,2,84,7,2,236,167
24524,9,36,72,2,295,15,8,428,276
86765,20,54,110,4,217,10,8,403,142
43481,12,80,3,1,73,0,8,165,27
113693,28,87,132,2,77,6,14,318,202
51176,14,66,281,3,72,23,16,461,55
6429,5,93,144,2,35,3,3,280,244
29447,9,27,56,2,386,18,7,496,288
51457,14,107,175,8,85,22,9,406,56
21244,9,20,93,1,177,13,2,306,295
9719,6,91,126,4,122,7,11,361,251
124437,30,73,73,0,94,5,10,255,220
129250,32,49,80,3,97,7,6,242,239
74526,16,80,13,2,132,1,4,232,106
33538,10,94,141,5,104,1,7,352,6
98510,23,63,48,1,66,5,8,191,169
89533,20,101,70,0,68,0,9,248,138
109260,26,60,135,0,110,6,13,324,192
27880,9,48,57,3,229,17,10,364,283
13058,7,98,60,2,99,10,17,286,263
53387,14,41,169,1,50,16,1,278,43
103548,25,81,82,1,73,3,1,241,180
6742,5,74,177,3,89,9,5,357,244
44467,12,41,34,4,136,4,12,231,30
40721,12,75,2,13,60,0,1,151,22
37814,11,83,185,2,49,7,9,335,21
21639,9,25,139,2,241,15,5,427,296
29701,9,34,28,5,228,7,11,313,288
54289,14,61,265,10,79,19,11,445,45
24596,9,33,122,2,196,14,8,375,276
40681,12,68,52,12,101,0,2,235,22
18424,8,50,68,1,50,3,2,174,271
115039,28,72,84,5,38,2,27,228,205
73177,16,59,186,4,64,4,17,334,103
51208,14,86,262,4,112,32,13,509,55
115723,28,60,104,1,70,5,5,245,206
29217,9,41,70,0,253,12,7,383,287
20760,9,24,116,1,207,12,4,364,294
83731,19,116,109,1,46,6,10,288,128
39338,11,42,267,4,69,19,12,413,11
84182,19,151,186,3,97,13,19,469,128
12433,7,87,44,1,83,8,6,229,261
105892,25,59,93,0,52,3,4,211,184
56649,15,99,141,4,178,24,23,469,68
80356,18,188,33,3,126,1,15,366,116
121128,30,60,113,5,133,20,6,337,213
39377,11,60,214,1,38,6,5,324,11
119742,30,46,82,0,48,0,5,181,230
88883,20,89,76,2,172,8,12,359,147
103882,25,131,211,1,33,0,1,377,180
74614,16,58,108,2,118,12,8,306,106
1462,2,74,154,4,45,7,13,297,129
106238,25,51,42,1,72,3,5,174,185
98059,23,162,204,0,100,4,12,482,168
77956,17,59,122,3,183,21,3,391,111
94240,21,46,147,1,128,23,13,358,151
124421,30,32,150,2,53,2,10,249,220
81330,19,101,260,6,64,14,11,456,122
47293,13,72,113,4,153,16,13,371,36
40760,12,30,10,0,73,1,4,118,22
72721,16,41,32,0,27,0,6,106,102
1928,2,86,190,4,102,21,5,408,130
97922,23,70,72,1,177,4,12,336,168
125250,30,92,131,1,139,3,11,377,222
25511,9,31,73,2,249,4,5,364,278
16719,8,72,91,0,44,11,7,225,268
87016,20,13,25,8,110,3,12,171,142
96763,22,47,232,5,125,10,10,429,165
123197,30,91,72,3,32,5,23,226,218
56198,15,107,88,5,96,2,10,308,57
102898,25,112,134,3,85,10,14,358,179
69796,15,54,41,0,21,1,3,120,86
106030,25,72,55,3,97,2,10,239,185
37398,11,57,169,5,70,11,9,321,20
126695,31,202,216,6,38,4,16,482,234
113945,28,91,30,2,17,1,2,143,203
105832,25,117,91,1,63,1,10,283,184
2755,2,47,156,5,51,12,9,280,132
97848,22,41,64,0,221,8,4,338,167
25835,9,26,96,3,227,9,7,368,279
28043,9,29,115,2,277,17,7,447,283
51771,14,57,371,2,54,9,4,497,39
81376,19,105,90,13,51,5,11,275,122
7808,5,76,123,6,47,2,6,260,246
93060,21,65,144,1,136,12,14,372,163
59683,15,60,99,7,190,23,4,383,58
39246,11,43,233,2,48,15,7,348,11
77730,17,35,205,4,177,16,9,446,110
45262,13,10,60,0,82,2,1,155,32
89970,20,51,20,1,146,2,9,229,139
545,1,103,150,5,174,19,17,468,2
5312,3,45,121,4,139,16,6,331,211
24678,9,45,84,2,312,12,1,456,276
130114,32,57,72,4,97,12,14,256,240
42277,12,46,45,7,132,9,12,251,25
31447,9,38,225,0,38,7,3,311,292
75551,16,71,103,1,94,9,11,289,108
124903,30,261,113,0,139,2,29,544,221
126174,30,178,23,4,154,4,22,385,225
122192,30,32,133,0,58,8,3,234,215
35523,11,29,204,3,34,5,12,287,16
16931,8,67,129,0,45,7,3,251,269
68446,15,46,53,3,222,15,10,349,82
43364,12,45,1,0,62,0,4,112,27
75948,16,61,292,0,119,12,8,492,98
42787,12,18,27,0,76,2,3,126,26
118731,30,78,260,2,102,18,1,461,227
38052,11,81,127,1,56,5,13,283,21
28357,9,18,53,0,238,10,7,326,284
16694,8,115,76,3,45,2,5,246,268
5390,3,27,117,0,94,9,6,253,211
57234,15,102,140,3,148,15,13,421,90
70986,15,48,64,13,148,11,6,290,89
31508,9,33,175,1,192,10,1,412,292
94331,21,65,148,2,126,16,9,366,151
15059,8,53,44,1,51,0,4,153,265
122137,30,55,143,4,53,4,5,264,215
81437,19,94,239,8,60,19,4,424,122
45100,13,127,234,1,68,1,30,461,31
92283,21,47,197,5,131,20,9,409,160
100478,24,42,121,2,100,8,5,278,174
76851,16,9,32,0,25,0,0,66,100
73068,16,56,107,2,108,6,15,294,103
52634,14,82,189,9,88,16,12,396,41
50215,14,133,189,2,68,15,19,426,53
22168,9,23,73,1,221,13,4,335,297
26138,9,29,61,0,327,11,10,438,279
90910,21,158,23,1,54,2,15,253,157
48442,14,53,261,2,27,14,13,370,49
83501,19,60,245,4,77,19,11,416,127
18993,8,74,204,8,64,12,4,366,272
127606,31,93,179,5,57,5,9,348,236
44810,12,41,28,3,97,0,7,176,30
2455,2,73,112,4,90,6,20,305,131
73099,16,18,34,2,73,2,4,133,103
9039,5,39,341,7,97,18,1,503,249
34830,11,103,176,0,12,3,16,310,14
90752,21,54,30,0,32,0,6,122,156
110972,27,101,6,0,147,1,35,290,196
76521,16,9,7,0,48,1,1,66,99
92262,21,34,226,1,158,13,9,441,160
104315,25,122,30,4,218,2,14,390,181
53563,14,132,213,3,61,18,9,436,43
12254,7,88,4,1,204,1,6,304,260
28507,9,27,51,18,202,14,0,312,284
88891,20,91,71,5,186,8,23,384,147
24926,9,43,142,2,197,14,7,405,277
116533,29,74,103,11,173,18,10,389,208
121413,30,55,152,1,199,12,4,423,214
100753,24,31,202,0,37,2,28,300,174
46769,13,90,114,8,128,13,10,363,35
16186,8,42,223,4,67,6,2,344,267
108723,26,43,163,0,138,9,21,374,191
51218,14,66,130,1,68,17,6,288,55
86471,20,48,67,1,184,9,3,312,141
56522,15,76,101,7,157,23,11,375,68
83335,19,27,109,4,41,7,24,212,127
100919,24,45,218,6,77,11,6,363,175
76049,16,47,71,1,129,3,5,256,98
96325,22,99,133,0,174,2,26,434,164
112267,28,90,135,1,64,11,10,311,199
57984,15,36,135,3,143,25,7,349,93
16627,8,51,71,3,26,5,5,161,268
119862,30,146,135,12,69,8,28,398,230
53751,14,127,144,3,60,15,14,363,43
76706,16,39,28,1,131,3,9,211,100
37223,11,48,133,2,73,3,3,262,19
126215,30,74,37,1,52,0,2,166,225
62885,15,26,422,0,24,3,0,475,66
54531,14,85,175,4,59,13,12,348,45
18918,8,73,159,4,52,6,19,313,272
22849,9,33,106,5,277,18,7,446,298
112934,28,59,76,1,48,3,10,197,201
25398,9,26,58,3,298,6,8,399,278
8930,5,59,290,2,123,15,4,493,249
97986,23,51,118,0,146,18,4,337,168
47649,13,69,31,10,69,4,7,190,37
1100,1,92,174,5,84,17,8,380,3
55799,14,91,115,0,41,4,9,260,48
86896,20,232,31,2,42,2,11,320,142
21968,9,19,122,2,196,7,5,351,297
16221,8,47,239,2,50,9,5,352,267
12724,7,43,115,2,94,2,4,260,262
120124,30,70,104,1,133,14,14,336,231
62670,15,58,71,3,213,9,8,362,65
105958,25,27,70,1,75,3,7,183,185
125011,30,57,123,0,109,6,11,306,222
117095,30,205,76,1,134,2,24,442,212
42889,12,66,5,0,61,2,5,139,26
49425,14,65,255,6,87,15,6,434,51
86926,20,76,94,1,164,16,8,359,142
14739,7,69,125,1,142,7,15,359,256
30757,9,28,68,3,273,11,2,385,291
105755,25,78,24,1,11,1,5,120,184
7350,5,60,14,1,4,0,0,79,246
83450,19,161,97,1,64,8,8,339,127
81484,19,48,316,5,65,12,7,453,122
60710,15,27,62,2,173,16,9,289,60
69935,15,116,56,0,88,3,9,272,86
554,1,80,137,4,104,24,8,357,2
45372,13,79,45,2,154,11,10,301,32
26013,9,2,39,0,353,22,9,425,279
17371,8,59,89,2,26,3,5,184,269
88820,20,73,52,1,201,3,17,347,146
70413,15,43,93,3,216,21,16,392,87
112637,28,54,111,0,66,4,9,244,200
101855,24,29,173,1,174,3,25,405,177
80613,19,13,447,0,24,3,2,489,117
18051,8,95,121,4,74,4,10,308,271
93787,21,67,206,1,83,4,8,369,150
12563,7,53,79,3,104,8,21,268,261
75729,16,45,260,0,76,10,6,397,98
69008,15,78,270,0,90,11,8,457,84
75192,16,18,45,0,127,5,15,210,107
108454,26,55,214,10,47,13,8,347,190
64625,15,33,347,0,73,14,2,469,71
108569,26,51,243,3,78,9,2,386,191
91452,21,35,40,5,177,10,10,277,158
117859,30,78,160,0,62,2,4,306,223
24892,9,43,137,0,192,22,6,400,277
47630,13,57,168,5,168,5,13,416,37
69396,15,79,137,3,143,7,8,377,85
103207,25,71,48,0,67,1,3,190,179
76494,16,47,23,1,94,3,2,170,99
128202,31,294,168,1,32,5,18,518,237
109466,27,102,12,0,35,1,1,151,193
105054,25,71,70,0,27,2,5,175,183
103861,25,50,125,1,38,8,11,233,180
82993,19,149,81,4,30,7,12,283,126
25007,9,49,60,3,214,9,11,346,277
68374,15,66,60,5,224,23,20,398,82
114826,28,78,95,1,28,0,5,207,204
33988,10,38,160,1,39,5,6,249,7
99049,24,27,35,0,26,0,10,98,171
58074,15,69,141,6,231,26,3,476,93
127234,31,77,168,2,49,10,9,315,235
88771,20,68,55,1,128,8,3,263,146
7743,5,11,14,0,6,0,2,33,246
6714,5,57,198,3,78,9,3,348,244
123050,30,61,51,0,125,3,2,242,217
41037,12,69,60,0,145,22,8,304,23
80574,19,99,325,4,60,4,11,503,117
94173,21,119,46,1,40,2,9,217,150
27625,9,21,53,1,220,10,5,310,282
121421,30,54,94,1,180,9,3,341,214
123373,30,37,109,3,108,8,7,272,218
16030,8,43,127,1,38,1,3,213,267
71674,16,79,42,2,101,2,5,231,97
78620,17,53,60,2,162,10,7,294,112
111051,27,191,4,0,166,0,16,377,197
83372,19,51,110,2,40,5,9,217,127
9671,6,51,96,0,28,1,4,180,251
107983,26,57,163,2,146,14,7,389,189
57118,15,53,118,3,232,21,6,433,90
101793,24,21,29,0,22,1,5,78,177
95870,21,111,112,5,19,1,8,256,155
26020,9,16,46,3,322,21,9,417,279
51981,14,78,176,2,60,15,15,346,39
47156,13,44,93,6,147,12,13,315,36
119422,30,62,69,1,166,4,13,315,229
24001,9,26,155,4,256,7,4,452,275
51383,14,90,118,4,58,12,9,291,56
42040,12,65,49,2,43,3,0,162,24
110832,27,150,7,0,202,2,6,367,196
1246,2,51,146,6,69,29,5,306,129
46747,13,74,71,1,74,4,8,232,35
95589,21,116,90,2,140,7,20,375,154
31959,9,32,62,3,378,15,4,494,293
64779,15,125,64,4,62,1,13,269,72
99946,24,133,114,4,79,11,57,398,173
86347,20,45,132,0,33,5,9,224,141
127212,31,97,209,3,79,22,9,419,235
23220,9,38,90,1,179,11,0,319,299
47489,13,61,40,4,24,5,5,139,37
57386,15,64,148,2,149,22,15,400,90
8080,5,169,138,5,75,14,9,410,247
49487,14,147,205,9,70,22,11,464,51
80789,19,112,78,26,43,5,4,268,117
23958,9,46,201,8,256,22,8,541,275
3299,2,65,136,2,43,5,6,257,133
27978,9,67,88,1,232,25,3,416,283
28670,9,45,116,2,312,22,9,506,286
82850,19,47,165,8,37,4,6,267,126
121300,30,60,136,1,105,20,6,328,213
114842,28,32,28,4,22,0,0,86,204
48886,14,76,160,3,19,3,4,265,50
27680,9,16,46,1,278,22,7,370,282
51680,14,34,273,1,48,17,3,376,39
11887,7,75,3,0,32,1,5,116,259
37946,11,44,219,5,32,8,9,317,21
94025,21,56,133,8,133,14,10,354,150
93558,21,49,165,2,120,6,4,346,149
101321,24,40,287,1,113,23,6,470,176
56253,15,141,85,6,142,6,15,395,57
64232,15,60,115,2,170,15,8,370,70
38304,11,36,183,4,156,28,5,412,9
62734,15,42,68,5,226,12,11,364,65
39839,11,17,130,4,17,4,20,192,12
37572,11,31,160,7,33,5,9,245,20
125573,30,67,138,1,69,4,22,301,224
14548,7,22,7,1,54,1,5,90,255
39299,11,55,291,5,57,19,3,430,11
129729,32,25,45,0,29,2,2,103,240
128847,32,47,116,1,29,6,11,210,238
66761,15,83,171,9,188,18,11,480,77
64300,15,67,77,1,173,7,12,337,70
97093,22,51,252,0,110,8,4,425,166
66108,15,101,180,4,67,30,10,392,75
58675,15,47,108,9,136,20,11,331,94
120878,30,27,300,1,95,4,20,447,232
114964,28,116,164,4,99,6,40,429,205
74928,16,39,141,1,119,6,12,318,107
8965,5,46,134,1,59,6,3,249,249
62392,15,39,117,6,151,9,14,336,64
41964,12,26,15,1,110,1,2,155,24
54146,14,108,256,4,45,6,14,433,44
103107,25,29,28,1,16,0,0,74,179
107313,26,64,224,6,46,8,4,352,188
14663,7,83,85,0,130,0,9,307,256
65445,15,72,67,4,159,10,0,312,73
129987,32,71,33,3,67,1,12,187,240
50850,14,92,118,7,79,12,4,312,55
74446,16,156,34,1,122,1,5,319,106
62024,15,75,73,12,209,7,26,402,64
2436,2,57,52,5,131,2,14,261,131
44835,12,69,63,4,162,3,14,315,30
41890,12,28,13,0,101,0,4,146,24
55974,14,79,127,7,69,10,16,308,48
119412,30,175,70,1,140,2,11,399,229
23976,9,24,314,1,32,3,3,377,275
84295,19,42,229,3,39,11,0,324,118
93313,21,61,83,1,65,11,14,235,163
25851,9,19,62,2,284,17,5,389,279
74297,16,55,69,2,124,5,15,270,105
87725,20,15,7,0,214,0,8,244,144
41018,12,82,95,3,183,15,7,385,23
47056,13,57,137,1,163,23,7,388,35
90728,21,60,123,4,117,12,5,321,156
36605,11,85,256,5,46,13,14,419,18
27289,9,35,148,4,220,22,8,437,282
21683,9,26,174,0,153,17,6,376,296
20693,9,28,143,5,223,5,4,408,294
3805,2,53,99,5,66,5,11,239,134
116430,29,95,142,2,149,9,8,405,208
37100,11,57,149,6,53,4,5,274,19
18602,8,79,66,4,69,5,7,230,271
79318,18,102,44,0,91,0,4,241,114
70276,15,68,120,7,188,18,11,412,87
41642,12,73,18,4,128,0,6,229,24
11344,7,180,25,0,46,2,10,263,258
1566,2,16,24,0,5,0,2,47,129
129237,32,63,104,1,105,11,7,291,239
120028,30,26,82,1,60,3,9,181,231
122988,30,61,50,2,163,4,5,285,217
125898,30,47,70,0,167,5,7,296,225
548,1,61,80,7,132,15,6,301,2
46400,13,213,11,7,87,4,22,344,34
66589,15,65,36,5,185,6,16,313,77
37583,11,74,125,1,32,3,12,247,20
93674,21,52,191,10,129,10,11,403,149
123037,30,61,56,1,136,2,6,262,217
117654,30,92,121,0,68,0,14,295,223
101500,24,61,269,1,80,11,5,427,176
24525,9,36,90,3,296,19,10,454,276
416,1,85,186,4,97,17,11,400,2
89663,20,189,26,0,211,1,17,444,139
53543,14,94,156,6,64,20,14,354,43
14153,7,69,64,1,94,4,4,236,254
23845,9,50,132,4,277,13,6,482,300
112166,28,46,137,4,53,3,5,248,199
106668,26,56,148,6,71,15,4,300,186
69244,15,90,168,7,80,10,18,373,84
3963,2,35,106,5,88,15,14,263,135
39109,11,39,319,6,74,16,8,462,11
18642,8,30,21,2,23,2,5,83,271
119325,30,65,112,0,166,3,8,354,229
82296,19,158,157,11,66,10,8,410,124
1141,1,48,150,8,61,12,10,289,3
17890,8,119,225,13,52,3,3,415,270
56210,15,28,127,3,127,11,10,306,57
105477,25,69,190,2,136,11,3,411,184
21853,9,29,141,0,138,7,6,321,296
18880,8,83,110,3,44,13,10,263,272
75639,16,45,157,1,114,9,11,337,98
73965,16,45,250,3,86,6,11,401,105
39505,11,32,176,3,39,14,7,271,12
24640,9,41,224,3,110,19,3,400,276
92423,21,86,110,1,68,2,29,296,161
43618,12,73,53,1,188,8,4,327,28
99694,24,64,131,20,100,6,15,336,172
55356,14,82,150,5,49,11,15,312,47
112078,28,109,151,1,93,16,8,378,199
55615,14,79,194,5,158,31,9,476,48
115834,29,37,120,1,169,8,9,344,207
105536,25,66,100,2,102,7,7,284,184
120700,30,88,93,4,121,8,9,323,232
73830,16,46,139,1,71,7,6,270,104
107950,26,38,140,0,130,5,11,324,189
16084,8,44,213,2,54,13,4,330,267
40698,12,65,63,0,103,2,2,235,22
97146,22,82,289,7,114,25,7,524,166
129785,32,16,27,0,19,3,0,65,240
13833,7,54,55,2,156,14,15,296,264
26793,9,31,75,3,229,17,4,359,281
85827,20,148,103,3,73,2,10,339,137
12932,7,53,51,1,169,6,13,293,262
81060,19,83,217,9,53,16,10,388,121
63023,15,97,102,2,197,15,7,420,66
72519,16,62,125,10,95,1,11,304,102
114239,28,55,107,2,85,6,4,259,203
32451,10,19,83,0,2,0,0,104,4
91196,21,85,91,1,123,2,15,317,158
112834,28,57,82,0,55,4,11,209,200
107523,26,46,326,1,73,10,0,456,188
87737,20,81,28,1,82,1,12,205,144
60723,15,10,28,0,132,13,2,185,60
59522,15,65,81,4,210,29,10,399,58
90524,21,37,103,0,53,1,7,201,156
61881,15,56,311,1,120,16,3,507,63
101746,24,39,91,0,112,1,18,261,177
8972,5,38,243,5,70,9,8,373,249
33136,10,118,93,6,105,6,12,340,6
3771,2,52,106,1,43,13,5,220,134
8579,5,96,111,2,111,7,11,338,248
23783,9,18,119,4,148,13,3,305,300
41356,12,83,88,2,75,1,8,257,23
85731,20,73,99,0,150,4,7,333,137
70548,15,79,67,5,170,16,18,355,88
111932,28,74,80,4,46,4,11,219,199
32777,10,128,115,1,94,4,6,348,5
112858,28,228,146,3,61,0,2,440,201
97077,22,65,212,1,125,12,4,419,166
30807,9,30,62,6,225,8,7,338,291
105393,25,11,16,0,7,0,1,35,183
115127,28,98,101,0,41,2,29,271,205
84656,19,96,174,10,83,13,6,382,119
37831,11,72,251,1,47,6,6,383,21
7559,5,57,166,0,55,8,5,291,246
99866,24,65,337,1,121,12,10,546,172
10681,7,208,5,0,13,1,17,244,257
104189,25,38,26,2,108,2,4,180,181
98473,23,118,126,6,91,8,7,356,169
82362,19,145,63,4,51,7,17,287,124
62294,15,45,127,10,137,14,17,350,64
120021,30,116,68,2,102,3,13,304,231
43553,12,105,18,2,108,0,7,240,28
100702,24,55,52,2,35,1,11,156,174
29832,9,21,106,1,209,13,8,358,289
15683,8,75,56,1,41,3,5,181,266
115501,28,67,127,2,58,16,12,282,206
619,1,87,217,3,98,12,15,432,2
84279,19,65,244,6,64,9,4,392,118
110811,27,229,23,2,269,7,9,539,196
98043,23,110,120,2,69,12,5,318,168
115715,28,74,169,1,75,8,11,338,206
90132,21,86,62,1,201,1,7,358,148
101756,24,194,107,0,45,1,29,376,177
62252,15,46,94,6,160,14,16,336,64
2768,2,67,148,3,87,11,6,322,132
6178,4,73,71,6,62,1,9,222,243
107880,26,50,76,4,156,6,9,301,189
46642,13,77,86,6,100,5,12,286,34
105505,25,56,229,2,189,15,6,497,184
60325,15,58,63,3,203,16,21,364,60
117447,30,114,77,1,198,48,12,450,212
85558,20,224,113,4,77,4,38,460,137
82743,19,96,184,2,66,10,13,371,125
118316,30,53,155,1,76,12,16,313,226
108966,26,42,114,1,94,6,8,265,191
90188,21,65,74,1,121,2,8,271,148
81065,19,141,121,1,38,5,11,317,121
125238,30,90,190,0,90,2,14,386,222
84907,19,101,196,4,55,21,7,384,119
86481,20,92,68,0,176,1,9,346,141
101702,24,109,123,0,32,3,30,297,177
129247,32,10,22,1,56,1,3,93,239
110600,27,127,17,1,268,1,11,425,196
25419,9,41,98,3,261,20,10,433,278
125160,30,67,110,1,147,10,9,344,222
69372,15,49,34,10,105,9,8,215,85
13915,7,31,8,0,120,0,9,168,254
102121,25,115,20,0,24,3,6,168,178
46954,13,69,85,4,193,6,2,359,35
89078,20,39,34,0,120,0,18,211,147
6604,5,94,94,2,68,3,4,265,244
49351,14,72,265,1,95,22,4,459,51
56320,15,96,109,9,95,7,12,328,57
108383,26,49,261,1,81,15,3,410,190
46161,13,83,93,1,166,5,8,356,33
85289,19,109,111,5,54,10,7,296,120
119181,30,34,121,1,49,2,14,221,229
76361,16,67,151,3,103,15,11,350,99
127765,31,76,176,4,74,9,8,347,236
77398,17,39,169,2,128,12,6,356,109
80231,18,58,67,1,75,0,6,207,116
18176,8,47,80,2,94,6,3,232,271
92295,21,51,191,5,131,24,5,407,160
127085,31,98,175,1,68,9,4,355,235
58186,15,63,96,5,213,21,8,406,93
21071,9,33,100,2,249,12,13,409,294
59184,15,120,86,6,126,16,26,380,96
50883,14,83,180,4,70,15,11,363,55
13080,7,64,43,1,132,10,11,261,263
3331,2,65,425,3,222,21,19,755,133
90231,21,182,22,1,216,0,20,441,148
119631,30,21,195,0,43,0,13,272,230
18415,8,124,110,6,27,5,16,288,271
43173,12,22,14,1,45,2,8,92,27
68370,15,59,64,4,190,22,11,350,82
24860,9,35,84,0,184,15,1,319,277
88095,20,82,28,0,187,0,2,299,145
36964,11,35,119,2,147,1,10,314,19
92514,21,54,135,0,93,4,12,298,161
71796,16,34,53,7,165,10,3,272,97
33057,10,78,94,2,48,1,9,232,5
102697,25,62,61,0,6,0,0,129,178
127984,31,114,110,2,34,2,5,267,237
52479,14,147,110,9,143,5,11,425,41
38095,11,27,165,2,19,0,7,220,21
41726,12,35,56,2,126,7,5,231,24
124270,30,116,159,4,37,4,12,332,220
106325,25,78,109,2,95,5,6,295,185
72283,16,52,105,0,120,3,3,283,101
5696,4,82,117,3,151,5,17,375,242
34666,11,40,228,6,98,25,5,402,14
18954,8,36,192,2,33,5,6,274,272
92942,21,42,96,1,85,3,7,234,162
13435,7,88,43,2,129,4,12,278,264
126399,31,61,65,0,50,0,2,178,233
49451,14,106,212,4,119,13,9,463,51
60368,15,98,71,2,218,23,10,422,60
32804,10,53,149,1,43,7,4,257,5
45675,13,51,151,7,216,6,6,437,32
13232,7,62,21,0,82,1,5,171,263
54750,14,66,137,12,30,11,9,265,46
105602,25,67,145,1,101,12,6,332,184
119155,30,38,166,5,120,10,15,354,228
7950,5,130,112,4,46,11,17,320,247
114290,28,109,103,5,117,7,8,349,203
87515,20,94,67,2,264,6,11,444,143
124449,30,109,101,1,93,6,11,321,220
111835,28,80,98,1,141,6,4,330,199
110889,27,98,3,2,214,1,6,324,196
124734,30,45,78,1,110,3,14,251,221
86736,20,45,23,3,160,2,3,236,142
22673,9,53,71,2,316,25,8,475,298
90282,21,175,196,2,42,2,22,439,148
85361,19,119,159,11,56,7,23,375,120
111117,27,93,6,6,130,2,2,239,197
126231,30,108,19,0,140,0,4,271,225
47305,13,91,145,6,131,12,6,391,36
81758,19,101,171,5,49,6,12,344,123
15403,8,66,83,1,57,13,3,223,265
83827,19,62,38,4,38,1,13,156,128
22486,9,31,90,0,193,15,2,331,298
33448,10,54,21,2,1,0,2,80,6
96740,22,41,168,6,145,10,11,381,165
2047,2,67,91,1,28,4,6,197,130
32414,10,42,35,1,11,1,2,92,4
2402,2,95,74,0,60,8,11,248,131
75366,16,60,93,2,161,11,7,334,108
65389,15,55,115,2,165,11,12,360,73
91225,21,88,86,6,96,3,27,306,158
100075,24,30,27,1,7,1,3,69,173
114713,28,57,119,4,92,4,3,279,204
17224,8,113,135,2,59,4,12,325,269
48763,14,74,143,5,44,10,14,290,50
22601,9,30,111,3,321,19,9,493,298
14894,7,112,61,2,120,2,7,304,256
95571,21,98,149,5,95,10,17,374,154
97497,22,51,209,3,127,13,13,416,167
3414,2,54,56,5,59,7,10,191,134
19447,8,58,144,1,34,6,9,252,273
10076,6,88,130,1,48,2,6,275,252
44337,12,94,5,1,124,2,6,232,29
10217,6,115,104,1,65,2,20,307,252
52169,14,82,102,3,34,5,10,236,40
58754,15,52,182,3,168,16,6,427,94
43523,12,115,11,1,51,1,17,196,28
80490,19,100,166,10,42,7,9,334,117
105021,25,38,28,0,20,0,5,91,183
103459,25,88,149,0,98,7,0,342,180
75495,16,38,182,0,138,0,3,361,108
18859,8,80,121,3,36,11,5,256,272
97426,22,101,138,4,108,5,7,363,167
50463,14,102,149,5,57,11,17,341,54
53183,14,97,129,4,52,13,10,305,42
19912,9,34,52,2,291,6,5,390,274
41435,12,14,9,0,76,0,0,99,23
22177,9,31,54,1,322,9,4,421,297
12872,7,94,82,3,80,3,16,278,262
90659,21,53,113,2,166,14,11,359,156
44931,13,38,24,1,115,0,12,190,31
19738,8,25,8,4,18,0,2,57,273
90565,21,52,117,2,54,2,10,237,156
53836,14,138,185,1,59,5,10,398,44
27161,9,29,35,3,279,17,7,370,281
71200,15,39,21,1,183,6,14,264,89
38691,11,145,94,2,37,2,9,289,10
115672,28,115,152,4,73,2,16,362,206
35889,11,76,176,4,10,5,9,280,17
120949,30,70,123,2,152,9,18,374,213
128663,32,37,61,3,64,2,16,183,238
127830,31,92,171,1,52,8,11,335,236
30211,9,27,135,1,111,7,0,281,289
64333,15,38,129,4,157,19,10,357,70
78463,17,99,69,16,166,8,19,377,112
42295,12,64,45,3,117,8,10,247,25
17121,8,47,125,5,47,5,8,237,269
22921,9,39,136,2,255,19,6,457,299
105815,25,90,55,0,24,1,5,175,184
107911,26,50,83,2,176,12,10,333,189
102561,25,29,32,0,21,0,5,87,178
114598,28,116,132,2,51,2,12,315,204
25583,9,35,135,2,160,22,6,360,278
122624,30,119,198,3,32,1,9,362,216
34303,11,24,173,0,60,7,20,284,8
55301,14,72,127,9,78,8,7,301,47
6216,4,77,107,8,111,4,16,323,243
92638,21,41,87,0,158,5,6,297,161
92705,21,61,142,2,74,4,15,298,162
129384,32,21,33,1,26,0,3,84,239
6769,5,97,50,0,34,3,16,200,244
2145,2,46,90,5,110,10,4,265,131
98401,23,97,139,1,83,13,11,344,169
80454,19,120,129,4,32,4,7,296,117
28491,9,26,67,3,277,10,5,388,284
45307,13,59,24,3,127,3,12,228,32
129657,32,90,165,8,45,4,21,333,239
62007,15,93,55,5,222,8,24,407,64
31454,9,21,102,1,147,10,1,282,292
54349,14,147,165,8,53,14,16,403,45
13645,7,84,122,2,188,13,7,416,264
63461,15,56,166,3,158,18,5,406,67
80836,19,52,224,10,66,6,6,364,117
120771,30,42,96,2,21,0,9,170,232
17435,8,44,163,9,41,8,3,268,269
72441,16,88,104,3,103,7,16,321,101
41034,12,63,83,5,201,8,4,364,23
129576,32,39,56,1,36,1,2,135,239
83025,19,102,127,3,58,11,11,312,126
19180,8,110,142,2,10,4,10,278,273
124971,30,94,49,5,41,3,33,225,221
57364,15,63,86,2,139,14,10,314,90
72272,16,52,69,0,55,5,6,187,101
74204,16,36,73,1,126,6,16,258,105
1220,1,153,80,6,60,11,11,321,3
57654,15,53,41,3,44,3,3,147,92
58367,15,34,158,2,130,17,5,346,94
34066,10,48,187,4,97,4,3,343,7
60559,15,224,91,5,185,7,14,526,60
112018,28,77,115,3,63,6,5,269,199
116197,29,84,76,2,174,3,11,350,207
10615,7,154,27,1,56,3,14,255,253
64804,15,108,75,3,60,1,3,250,72
129582,32,25,10,0,6,0,1,42,239
88299,20,126,14,1,65,2,26,234,145
98435,23,101,86,2,71,7,13,280,169
113450,28,106,144,0,65,5,20,340,202
70253,15,44,60,1,183,8,7,303,87
24403,9,19,195,0,50,5,6,275,275
100898,24,82,200,5,108,10,8,413,175
91700,21,68,194,3,156,15,6,442,159
2900,2,49,74,1,50,1,8,183,133
34927,11,24,300,4,100,7,14,449,14
71807,16,45,27,1,200,13,12,298,97
129170,32,3,24,3,29,0,1,60,239
83513,19,67,380,8,60,17,5,537,127
1885,2,54,107,2,45,6,6,220,130
20024,9,18,47,2,276,7,2,352,274
14332,7,142,12,2,133,0,11,300,255
31598,9,25,70,1,224,12,1,333,292
17989,8,60,296,5,51,20,3,435,270
36846,11,134,208,0,24,4,7,377,19
19462,8,49,124,8,44,13,7,245,273
45328,13,67,17,2,60,0,6,152,32
90393,21,148,88,0,52,2,21,311,148
30430,9,32,152,2,159,16,5,366,290
93431,21,57,236,1,62,4,11,371,149
712,1,67,182,1,121,13,6,390,2
126663,31,155,119,0,10,1,5,290,234
13796,7,49,74,2,151,14,9,299,264
107126,26,68,165,2,37,4,9,285,187
126545,31,139,181,1,9,1,4,335,233
2647,2,61,108,5,53,11,5,243,132
8474,5,63,70,1,51,3,7,195,248
128659,32,8,49,2,185,3,14,261,238
61141,15,42,67,10,168,12,12,311,61
120356,30,69,84,2,163,2,13,333,231
32046,10,94,123,4,69,5,12,307,4
66746,15,45,72,1,78,7,3,206,77
117240,30,57,31,0,47,1,10,146,212
4638,2,66,119,4,78,11,10,288,136
74549,16,40,138,2,98,4,2,284,106
119818,30,94,86,1,42,0,7,230,230
67590,15,55,53,3,144,5,1,261,80
32782,10,52,236,0,63,14,2,367,5
106455,26,112,146,0,24,1,9,292,186
72063,16,44,118,0,67,6,12,247,101
119636,30,88,38,3,102,1,21,253,230
104809,25,58,56,27,45,2,9,197,182
104674,25,30,158,3,63,11,4,269,182
83741,19,78,131,0,71,2,5,287,128
35612,11,111,178,3,78,28,15,413,16
78465,17,67,80,12,150,5,12,326,112
29346,9,33,60,2,297,11,4,407,287
32265,10,28,51,0,28,0,0,107,4
110605,27,120,17,1,192,4,6,340,196
73361,16,29,35,4,77,2,9,156,103
65980,15,76,197,3,78,16,12,382,75
54784,14,37,175,3,79,0,6,300,46
123175,30,270,99,3,31,5,22,430,218
3998,2,50,93,4,64,0,9,220,135
112783,28,84,133,0,87,4,12,320,200
113769,28,75,123,0,105,9,7,319,202
99543,24,21,32,0,9,2,3,67,172
26567,9,29,176,3,278,25,11,522,280
116526,29,53,146,5,124,5,15,348,208
22436,9,27,64,3,195,13,15,317,298
77836,17,78,87,4,107,4,11,291,110
63253,15,43,210,2,161,26,1,443,67
78626,17,51,71,2,192,11,9,336,112
50482,14,119,144,19,100,17,10,409,54
116858,29,50,141,0,99,11,5,306,209
92355,21,173,98,6,61,2,39,379,161
1268,2,60,99,2,92,7,10,270,129
78278,17,36,41,32,166,7,15,297,112
103844,25,76,152,1,53,8,2,292,180
7770,5,63,239,7,45,11,3,368,246
13962,7,82,42,1,56,0,7,188,254
9961,6,16,42,0,10,2,1,71,252
104813,25,66,105,2,47,6,6,232,182
93049,21,51,132,1,82,13,5,284,163
75235,16,210,48,2,110,2,7,379,108
31381,9,21,38,1,257,9,13,339,292
60456,15,49,73,5,234,25,8,394,60
116266,29,68,130,2,199,11,13,423,208
64297,15,79,78,2,170,12,1,342,70
5613,4,79,108,5,127,6,7,332,242
122845,30,94,47,1,211,2,11,366,217
121657,30,111,190,2,301,6,6,616,214
125640,30,103,100,0,55,4,9,271,224
9351,5,82,210,9,63,15,22,401,250
105235,25,55,119,4,148,22,4,352,183
63949,15,41,62,4,220,30,20,377,69
26689,9,49,161,3,143,17,1,374,280
95944,21,200,31,2,79,1,7,320,155
58760,15,36,235,4,152,24,5,456,94
48576,14,80,184,8,120,10,29,431,49
121707,30,62,46,1,232,7,11,359,214
128455,32,55,81,2,108,11,18,275,238
105643,25,44,76,3,116,8,2,249,184
117775,30,49,176,1,85,4,9,324,223
80413,18,103,29,6,123,15,5,281,116
47348,13,77,129,5,171,20,12,414,36
108040,26,46,122,0,148,11,11,338,189
53124,14,71,228,2,57,17,14,389,42
34332,11,66,177,4,43,4,10,304,8
127203,31,123,106,2,45,6,9,291,235
13849,7,152,43,0,103,0,110,408,254
22538,9,24,65,2,262,9,9,371,298
44737,12,38,60,3,155,9,11,276,30
20394,9,30,140,2,94,12,7,285,285
42465,12,70,45,1,150,12,9,287,25
4789,3,63,88,1,100,5,6,263,210
38692,11,57,127,0,17,4,5,210,10
39367,11,74,214,0,29,3,11,331,11
4590,2,48,92,12,43,8,5,208,136
90677,21,76,90,1,62,6,16,251,156
17731,8,87,110,6,29,9,16,257,270
62812,15,43,155,1,166,22,8,395,65
123352,30,92,43,0,94,2,7,238,218
99882,24,27,55,0,14,1,7,104,172
46298,13,69,114,3,82,10,12,290,34
33512,10,145,44,0,39,1,17,246,6
23118,9,32,81,2,211,10,3,339,299
126207,30,78,115,1,100,1,8,303,225
119942,30,81,115,4,103,4,22,329,230
25712,9,25,82,0,222,12,10,351,278
121446,30,69,87,1,157,7,2,323,214
13141,7,81,4,3,66,2,10,166,263
10756,7,104,1,0,0,1,1,107,257
54852,14,60,69,0,93,2,7,231,46
38432,11,50,103,0,40,5,11,209,9
87349,20,236,6,0,247,1,8,498,143
83645,19,158,123,5,61,13,11,371,127
93133,21,43,127,5,82,14,6,277,163
53788,14,57,355,2,142,20,9,585,44
75757,16,41,205,0,156,9,7,418,98
27473,9,41,134,6,223,25,5,434,282
43754,12,69,72,1,160,11,6,319,28
7726,5,72,185,3,79,15,4,358,246
74862,16,43,149,2,118,15,7,334,107
29762,9,32,110,2,189,16,9,358,289
4984,3,62,78,7,133,12,4,296,210
68163,15,35,62,3,201,22,7,330,82
25621,9,44,51,2,208,6,0,311,278
92668,21,52,6,0,70,2,3,133,162
10303,7,114,8,1,140,0,8,271,253
97251,22,82,173,2,107,14,10,388,166
3606,2,74,124,6,73,5,2,284,134
6077,4,70,87,4,140,1,2,304,243
104130,25,48,90,2,54,2,1,197,181
42400,12,64,42,2,208,8,10,334,25
120556,30,200,77,0,75,7,21,380,232
93214,21,77,157,4,106,12,22,378,163
118767,30,84,124,1,75,4,5,293,228
111491,27,175,35,1,251,6,3,471,198
16454,8,77,163,5,53,16,9,323,268
121170,30,74,110,5,155,15,15,374,213
45005,13,137,9,2,72,1,17,238,31
80723,19,81,94,29,28,7,10,249,117
30673,9,50,279,5,149,18,3,504,290
47954,14,69,140,2,104,8,7,330,38
130533,32,76,60,0,102,4,8,250,241
70701,15,54,71,4,207,22,14,372,88
116468,29,28,163,2,186,8,12,399,208
643,1,50,200,6,93,12,7,368,2
105215,25,47,131,4,102,10,10,304,183
23590,9,43,70,2,209,15,4,343,300
75219,16,82,63,1,136,4,5,291,108
109629,27,77,13,0,336,3,3,432,193
110476,27,133,15,1,245,2,8,404,195
54890,14,142,64,0,9,3,10,228,46
120299,30,143,107,7,101,4,18,380,231
30783,9,31,42,4,255,11,11,354,291
48438,14,64,231,1,50,9,10,365,49
22126,9,23,76,0,238,19,0,356,297
14197,7,87,42,0,142,2,15,288,254
59869,15,73,95,6,215,15,5,409,58
99789,24,62,76,0,4,3,0,145,172
11550,7,184,30,0,135,0,4,353,259
78133,17,91,123,1,137,4,19,375,111
24787,9,82,137,0,198,30,2,449,276
78977,17,58,100,2,131,9,16,316,113
65189,15,68,95,3,164,13,10,353,73
38806,11,60,126,3,64,4,9,266,10
59309,15,76,49,4,116,4,14,263,96
41344,12,126,74,2,66,4,12,284,23
11449,7,94,10,5,87,1,9,206,258
100132,24,20,33,1,22,1,5,82,173
106659,26,47,122,1,76,6,4,256,186
57790,15,64,127,8,117,14,9,339,92
42047,12,63,39,4,150,8,9,273,25
1873,2,50,149,1,47,11,2,260,130
65006,15,70,137,8,117,11,26,369,72
106736,26,36,148,2,94,13,7,300,186
41880,12,8,16,0,48,0,4,76,24
79740,18,108,80,2,125,14,2,331,115
126414,31,172,237,0,20,0,11,440,233
112627,28,52,266,3,117,12,10,460,200
117278,30,100,122,6,129,5,24,386,212
94842,21,49,31,2,5,0,7,94,152
9538,6,92,149,1,103,9,11,365,251
63937,15,96,57,1,212,22,9,397,69
58888,15,74,80,5,193,21,10,383,95
71171,15,76,67,4,176,7,8,338,89
84068,19,145,43,9,8,0,8,213,128
98893,23,31,113,2,87,12,5,250,170
127899,31,57,130,4,46,8,11,256,236
2361,2,48,128,4,56,10,15,261,131
34515,11,53,128,8,90,10,22,311,8
65433,15,54,95,2,159,9,7,326,73
60003,15,47,203,0,157,18,2,427,59
85043,19,22,83,0,31,3,0,139,120
63169,15,76,134,7,145,16,15,393,66
53065,14,83,240,1,102,26,18,470,42
32568,10,72,92,0,90,4,10,268,5
15702,8,108,86,7,50,7,18,276,266
26554,9,47,186,5,164,14,5,421,280
14323,7,78,42,3,105,1,14,243,255
73116,16,21,103,1,87,4,4,220,103
99025,24,35,87,4,15,7,7,155,171
78697,17,59,56,1,78,9,14,217,113
89274,20,45,51,4,208,1,5,314,138
128336,31,195,184,1,32,1,11,424,237
71770,16,45,79,2,219,6,8,359,97
50392,14,39,398,0,65,11,0,513,53
118636,30,43,234,1,56,3,3,340,227
76894,16,78,216,1,84,10,11,400,100
111821,27,166,13,1,207,6,12,405,198
73448,16,23,107,0,48,5,7,190,104
95592,21,92,115,3,97,7,11,325,154
2944,2,61,255,1,39,12,2,370,133
109728,27,184,11,1,90,1,7,294,193
91491,21,44,96,7,99,3,27,276,158
97121,22,32,251,3,110,17,4,417,166
102514,25,39,39,0,31,1,10,120,178
21332,9,24,68,1,278,12,2,385,295
72362,16,36,74,3,88,1,11,213,101
78531,17,64,72,2,185,7,9,339,112
69161,15,81,210,5,86,12,6,400,84
109717,27,174,7,2,173,0,8,364,193
119895,30,79,96,4,61,3,4,247,230
38145,11,30,182,4,30,0,16,262,21
100825,24,55,212,5,95,16,15,398,175
129501,32,3,15,0,80,0,0,98,239
62685,15,41,85,2,152,11,3,294,65
98137,23,96,83,2,119,14,7,321,168
40092,11,61,242,7,54,16,6,386,13
38087,11,74,290,2,57,11,7,441,21
85380,19,165,170,12,86,3,8,444,120
18408,8,64,119,6,55,5,4,253,271
78655,17,60,62,12,195,10,7,346,112
80484,19,158,176,6,50,8,27,425,117
15901,8,79,98,1,61,8,12,259,266
19072,8,86,113,5,54,10,0,268,272
10920,7,258,30,0,105,1,0,394,257
30901,9,25,59,7,249,8,12,360,291
47297,13,88,169,7,173,22,11,470,36
127201,31,156,226,3,96,17,18,516,235
104586,25,74,199,3,215,19,3,513,182
107165,26,50,125,1,35,4,6,221,187
68078,15,48,91,3,259,16,0,417,81
8974,5,57,293,0,101,9,3,463,249
123986,30,59,186,1,169,7,9,431,219
102724,25,58,71,0,60,0,8,197,178
108071,26,80,109,3,102,0,11,305,189
114934,28,86,126,7,80,3,3,305,205
60278,15,51,169,1,167,24,7,419,59
72606,16,58,72,4,214,4,9,361,102
99609,24,48,205,3,73,23,11,363,172
29598,9,26,35,2,227,21,2,313,288
97676,22,49,185,0,72,14,6,326,167
32014,10,45,76,5,103,6,26,261,4
38710,11,68,164,1,10,4,6,253,10
55221,14,74,124,4,117,9,7,335,47
112766,28,84,195,2,76,7,11,375,200
35419,11,116,108,0,17,5,4,250,15
6915,5,73,71,0,81,6,7,238,245
113730,28,60,159,5,79,11,2,316,202
71750,16,34,53,1,210,11,6,315,97
81136,19,89,175,5,57,11,7,344,121
32633,10,139,111,0,65,7,10,332,5
89145,20,46,72,2,201,9,9,339,147
23392,9,48,147,3,197,23,6,424,299
118995,30,52,115,1,88,5,13,274,228
45231,13,106,60,6,123,2,16,313,31
45044,13,124,38,4,80,0,11,257,31
88643,20,62,64,1,136,7,16,286,146
52170,14,84,100,1,38,4,5,232,40
5888,4,58,4,0,60,1,8,131,242
87523,20,39,1,0,24,0,0,64,143
87285,20,66,47,0,184,2,8,307,143
104407,25,36,88,0,73,9,4,210,182
71716,16,38,81,0,175,11,6,311,97
37808,11,32,238,0,30,4,1,305,21
115481,28,81,160,1,57,12,4,315,206
33179,10,63,62,1,18,0,1,145,6
128034,31,172,145,1,69,3,11,401,237
114892,28,174,173,2,106,6,7,468,204
44557,12,72,55,4,179,9,8,327,30
88496,20,81,73,3,185,13,17,372,146
39762,11,23,121,2,79,11,22,258,12
105902,25,14,20,0,2,1,1,38,184
5478,4,70,100,3,81,8,21,283,242
119013,30,100,119,3,136,17,20,395,228
34812,11,82,129,3,17,4,17,252,14
20608,9,29,82,2,197,15,3,328,285
10401,7,99,18,1,130,1,7,256,253
1337,2,69,204,7,74,12,13,379,129
20247,9,43,201,0,187,11,9,451,285
2505,2,52,112,5,76,14,7,266,132
113996,28,118,37,1,2,2,6,166,203
86107,20,109,9,1,63,0,15,197,140
22756,9,31,125,1,178,14,7,356,298
108308,26,64,290,2,79,24,2,461,190
77348,17,36,176,0,97,15,3,327,109
51401,14,78,205,6,103,15,12,419,56
116559,29,44,134,2,174,12,18,384,208
119592,30,124,80,0,16,0,7,227,230
86306,20,80,58,3,121,11,10,283,141
86941,20,289,31,2,57,0,21,400,142
29869,9,22,59,1,355,16,10,463,289
26136,9,32,42,2,289,12,9,386,279
93138,21,49,165,3,131,20,4,372,163
87658,20,14,10,1,97,3,16,141,144
89527,20,132,18,0,28,0,9,187,138
125544,30,98,47,2,138,3,20,308,224
106945,26,50,135,4,151,15,2,357,187
121746,30,79,25,2,143,6,5,260,214
28754,9,29,74,1,293,8,9,414,286
63172,15,74,100,2,142,10,12,340,66
76912,16,81,120,2,175,7,9,394,100
174,1,93,200,5,64,12,3,377,1
94239,21,51,153,1,104,22,20,351,151
120341,30,84,95,1,68,2,10,260,231
26052,9,27,76,0,323,14,7,447,279
32266,10,33,74,0,16,1,0,124,4
44956,13,137,115,5,125,9,8,399,31
26386,9,41,316,2,128,19,5,511,280
121257,30,55,98,2,119,17,4,295,213
9493,6,82,252,4,88,19,0,445,251
88711,20,67,86,0,180,9,0,342,146
118461,30,75,214,0,104,17,11,421,227
87894,20,40,17,0,77,1,10,145,144
73239,16,49,161,0,67,3,1,281,103
74941,16,44,143,0,116,11,9,323,107
113232,28,87,83,3,88,6,17,284,201
45780,13,19,6,0,45,0,6,76,32
50762,14,134,194,4,38,7,8,385,54
15515,8,139,84,8,63,13,1,308,265
53613,14,55,308,2,81,24,5,475,43
117969,30,66,96,1,136,7,11,317,226
61069,15,74,103,12,204,18,5,416,61
102630,25,28,50,0,8,0,3,89,178
898,1,76,238,2,83,10,7,416,3
54050,14,38,268,3,125,15,9,458,44
29499,9,37,58,5,206,11,14,331,288
83471,19,156,95,6,44,16,17,334,127
43595,12,101,34,9,119,11,12,286,28
118922,30,96,159,2,128,5,19,409,228
11749,7,81,94,4,60,2,19,260,259
97049,22,63,161,3,86,14,13,340,166
126742,31,175,203,2,64,6,14,464,234
84447,19,36,328,2,45,10,3,424,118
55025,14,70,276,3,44,12,9,414,46
54540,14,112,171,9,92,17,3,404,45
1062,1,94,74,2,52,8,11,241,3
86092,20,107,35,1,173,2,8,326,140
73181,16,54,112,2,42,1,12,223,103
119296,30,65,87,0,77,0,13,242,229
100807,24,130,278,0,62,1,27,498,174
99106,24,36,65,0,5,1,6,113,171
99855,24,65,214,1,2,1,6,289,172
57815,15,80,110,5,189,11,7,402,92
43401,12,59,4,0,153,0,10,226,27
104046,25,42,169,0,140,4,11,366,181
167,1,78,177,9,56,14,14,348,1
110715,27,128,11,1,217,1,6,364,196
52594,14,80,205,6,65,9,11,376,41
32570,10,95,186,3,104,12,6,406,5
120652,30,49,138,1,145,12,9,354,232
95913,21,100,112,0,181,2,11,406,155
93490,21,59,263,4,151,21,11,509,149
69869,15,109,154,7,122,8,15,415,86
46957,13,70,38,1,157,10,5,281,35
10722,7,115,68,0,141,3,15,342,257
109821,27,90,20,1,315,1,8,435,194
125519,30,107,96,1,91,2,11,308,224
40840,12,47,51,2,40,0,0,140,22
104065,25,57,38,2,17,1,2,117,181
27184,9,54,150,1,217,15,8,445,281
124336,30,43,18,1,29,1,6,98,220
6368,4,140,102,2,78,0,11,333,243
101643,24,49,147,0,46,9,4,255,176
15429,8,59,88,3,60,7,3,220,265
78288,17,35,48,25,115,11,15,249,112
77497,17,41,143,2,129,7,8,330,110
55195,14,154,86,10,38,1,9,298,47
109797,27,162,9,0,172,0,11,354,193
97677,22,65,260,0,100,10,8,443,167
54441,14,116,129,4,52,13,9,323,45
120548,30,127,64,4,66,3,23,287,232
87764,20,174,12,1,100,1,15,303,144
84405,19,208,63,4,39,12,10,336,118
47577,13,93,109,9,133,12,21,377,37
82512,19,37,265,1,39,11,2,355,125
30808,9,32,35,4,253,11,9,344,291
89732,20,227,37,0,141,1,9,415,139
99620,24,40,258,2,120,25,6,451,172
56203,15,132,109,9,162,10,14,436,57
7191,5,83,39,7,208,7,15,359,245
85077,19,117,116,4,134,4,11,386,120
101226,24,15,205,0,7,1,7,235,175
48233,14,110,64,10,89,14,12,299,38
115922,29,35,129,2,122,4,13,305,207
18648,8,31,9,0,9,0,1,50,271
101916,24,55,50,1,155,3,32,296,177
54928,14,74,155,7,76,4,5,321,46
87935,20,40,52,0,59,5,11,167,144
98073,23,156,177,3,96,9,5,446,168
41922,12,48,17,1,142,1,6,215,24
126984,31,107,115,1,31,0,3,257,234
63391,15,64,103,4,169,9,6,355,67
53887,14,75,173,12,75,9,11,355,44
43821,12,89,22,3,50,1,13,178,28
117211,30,26,22,0,36,1,0,85,212
946,1,62,159,2,53,10,11,297,3
127139,31,70,182,2,60,9,12,335,235
88195,20,124,19,0,214,0,2,359,145
48481,14,79,197,3,34,9,6,328,49
39386,11,65,161,2,22,4,12,266,11
128111,31,158,201,1,58,3,4,425,237
85612,20,66,85,0,86,6,2,245,137
27306,9,26,153,8,263,16,14,480,282
44223,12,130,19,1,131,3,8,292,29
58218,15,66,152,2,211,32,11,474,93
123200,30,166,118,0,47,4,4,339,218
10944,7,129,10,0,107,1,3,250,257
46083,13,42,79,9,86,10,19,245,33
82254,19,194,63,5,35,9,14,320,124
35818,11,76,97,3,37,6,7,226,16
34701,11,22,127,1,41,2,8,201,14
84759,19,93,152,6,61,10,9,331,119
96633,22,88,174,1,105,11,10,389,165
118944,30,52,135,1,107,5,6,306,228
51361,14,83,212,1,82,22,8,408,56
108890,26,51,118,1,113,10,5,298,191
3082,2,54,145,7,49,11,5,271,133
39025,11,30,155,2,39,4,15,245,10
81793,19,58,367,4,61,5,3,498,123
21390,9,37,84,3,311,10,6,451,295
3251,2,26,128,4,45,10,6,219,133
52643,14,97,187,15,88,16,16,419,41
73606,16,27,26,0,264,2,19,338,104
98088,23,150,187,4,107,11,8,467,168
10351,7,75,44,1,96,2,15,233,253
10500,7,94,2,0,68,3,7,174,253
36694,11,76,176,6,67,3,14,342,18
73235,16,41,167,0,66,4,8,286,103
39828,11,39,88,0,134,7,22,290,12
19436,8,142,82,6,30,2,17,279,273
1461,2,86,93,3,36,6,5,229,129
24233,9,21,125,1,123,8,5,283,275
45597,13,93,47,14,218,7,6,385,32
102506,25,39,4,0,5,0,0,48,178
74242,16,64,168,2,153,10,13,410,105
115021,28,56,120,1,50,2,21,250,205
95961,21,181,164,2,44,2,28,421,155
19951,9,20,38,2,274,7,14,355,274
130602,32,37,182,4,92,6,16,337,241
5438,3,17,8,0,46,3,1,75,211
125385,30,80,119,4,124,8,8,343,222
5086,3,36,74,2,108,12,12,244,210
87964,20,61,18,3,292,8,6,388,144
90844,21,147,115,1,118,2,26,409,157
51855,14,46,308,1,109,22,0,486,39
14108,7,52,25,0,133,4,11,225,254
52833,14,120,140,4,71,13,16,364,41
117243,30,89,68,2,42,3,11,215,212
57623,15,45,85,2,238,17,20,407,92
32402,10,119,182,6,60,4,10,381,4
14074,7,98,26,3,166,0,9,302,254
14615,7,61,123,0,152,1,12,349,255
13926,7,92,16,0,133,1,14,256,254
66768,15,81,125,5,123,25,8,367,77
20685,9,37,134,1,226,19,6,423,294
904,1,71,178,3,65,19,11,347,3
67711,15,39,65,7,188,12,12,323,80
39861,11,14,218,1,107,14,13,367,12
116022,29,94,105,3,109,5,15,331,207
103905,25,127,274,2,329,8,1,741,181
104190,25,26,19,1,72,1,3,122,181
124514,30,58,62,0,84,5,10,219,220
19680,8,19,47,0,8,0,1,75,273
100930,24,63,230,0,72,17,11,393,175
61877,15,40,247,1,81,21,5,395,63
12921,7,36,81,0,166,2,16,301,262
62960,15,16,261,0,18,2,0,297,66
103190,25,54,50,0,53,1,5,163,179
33173,10,22,92,1,16,0,3,134,6
19351,8,56,41,1,19,1,5,123,273
93469,21,25,76,5,118,5,9,238,149
18009,8,16,11,1,12,0,3,43,271
58876,15,47,84,6,238,17,7,399,95
96458,22,51,101,4,72,9,12,249,164
28086,9,46,38,2,263,10,7,366,283
12477,7,87,46,1,185,3,17,339,261
4194,2,70,63,5,93,9,16,256,135
102696,25,44,62,0,6,0,5,117,178
85092,19,124,139,3,117,8,11,402,120
42249,12,84,228,3,413,22,10,760,25
63095,15,87,165,4,121,20,9,406,66
123391,30,33,93,2,121,9,11,269,218
127445,31,102,143,6,39,3,13,306,235
77367,17,47,125,3,108,7,8,298,109
1287,2,47,110,3,55,13,6,234,129
84568,19,73,134,2,41,3,6,259,118
36307,11,76,229,6,33,11,14,369,17
13364,7,88,7,0,185,3,21,304,263
128759,32,69,71,2,62,2,12,218,238
111730,27,124,9,1,142,0,4,280,198
37032,11,71,351,2,44,6,10,484,19
126526,31,124,100,1,17,2,2,246,233
90592,21,58,114,2,130,6,13,323,156
25353,9,40,143,2,266,21,2,474,277
71150,15,90,77,3,207,13,4,394,89
73608,16,59,75,0,212,2,2,350,104
33353,10,120,151,3,128,4,12,418,6
101610,24,55,210,2,36,18,10,331,176
66344,15,113,264,2,106,26,20,531,76
10070,6,87,137,1,68,6,9,308,252
123101,30,53,36,3,149,3,8,252,217
80317,18,92,42,2,82,1,6,225,116
65322,15,60,191,1,61,17,4,334,73
51616,14,67,192,7,98,19,11,394,56
21782,9,46,202,2,131,15,3,399,296
31237,9,29,56,3,266,9,8,371,292
79738,18,82,78,1,194,18,6,379,115
124313,30,60,107,1,66,8,18,260,220
22930,9,22,77,3,196,14,8,320,299
120852,30,59,89,0,108,2,4,262,232
12913,7,56,92,2,167,2,14,333,262
726,1,77,173,4,88,13,7,362,2
11401,7,103,5,8,2,0,8,126,258
116179,29,75,100,3,167,4,9,358,207
113864,28,71,109,0,88,2,19,289,202
43436,12,110,43,1,108,1,7,270,27
76135,16,43,5,0,41,1,2,92,99
67609,15,47,62,5,241,23,14,392,80
41588,12,15,7,1,151,1,4,179,24
104415,25,28,94,1,80,9,6,218,182
82478,19,79,136,2,20,2,7,246,125
19802,9,29,71,2,309,16,11,438,274
30241,9,36,178,0,118,6,2,340,290
18593,8,66,81,13,77,10,5,252,271
42620,12,30,12,1,42,1,3,89,26
24882,9,23,137,0,130,12,2,304,277
76479,16,22,20,0,86,4,6,138,99
48814,14,131,284,0,37,5,7,464,50
54529,14,110,226,7,82,21,14,460,45
32382,10,163,137,4,46,3,7,360,4
115502,28,62,161,1,72,6,5,307,206
64575,15,20,287,3,70,3,5,388,71
86930,20,63,76,2,17,1,4,163,142
97453,22,133,147,3,88,0,11,382,167
62790,15,51,140,2,215,22,8,438,65
47184,13,58,66,5,145,17,18,309,36
36963,11,41,17,2,134,1,7,202,19
16209,8,49,106,3,40,5,3,206,267
106482,26,72,201,2,70,23,4,372,186
96909,22,74,153,2,49,0,13,291,165
52627,14,149,190,6,70,11,9,435,41
16171,8,89,158,5,76,5,6,339,267
124288,30,87,152,0,79,7,14,339,220
110607,27,139,17,0,151,2,4,313,196
103251,25,39,45,0,101,5,8,198,179
37539,11,53,238,5,35,3,11,345,20
97504,22,60,203,3,123,7,6,402,167
38371,11,40,150,0,44,1,11,246,9
13192,7,84,15,2,118,3,19,241,263
121236,30,45,138,0,103,15,2,303,213
123586,30,48,121,0,148,9,12,338,218
15657,8,98,60,4,52,7,5,226,266
6234,4,117,101,3,98,0,20,339,243
23633,9,35,115,0,210,6,12,378,300
30084,9,58,299,0,96,9,2,464,289
23346,9,23,41,0,188,11,4,267,299
9499,6,86,120,3,70,10,5,294,251
62893,15,33,286,1,30,10,4,364,66
105007,25,59,74,1,75,1,6,216,183
46584,13,45,87,7,112,7,5,263,34
62530,15,62,93,4,206,21,8,394,65
84115,19,78,87,1,69,60,28,323,128
30245,9,91,378,1,260,14,13,757,290
128379,31,98,116,0,76,12,8,310,237
123408,30,23,87,1,120,7,5,243,218
59637,15,68,104,8,209,15,9,413,58
42580,12,24,0,0,6,1,2,33,26
99571,24,75,93,5,77,13,15,278,172
115157,28,74,238,7,115,11,6,451,205
115372,28,68,245,2,87,12,2,416,206
125903,30,55,72,1,229,0,7,364,225
61443,15,34,228,3,133,22,10,430,62
2341,2,67,128,1,71,12,12,291,131
44967,13,77,43,2,148,3,11,284,31
74522,16,8,4,0,230,0,0,242,106
109300,26,62,163,2,171,8,9,415,192
109496,27,128,18,1,144,3,1,295,193
70131,15,60,24,1,65,2,15,167,86
87364,20,187,22,2,90,4,16,321,143
35163,11,45,249,3,14,12,11,334,15
80828,19,53,206,18,55,10,9,351,117
90052,21,149,94,1,115,2,16,377,148
100803,24,42,135,3,25,0,19,224,174
81534,19,33,403,0,43,7,1,487,122
115368,28,73,267,1,110,18,9,478,206
80904,19,122,165,7,55,18,15,382,121
16236,8,57,167,3,55,14,5,301,267
15157,8,51,15,1,13,1,6,87,265
126227,30,239,59,1,236,0,7,542,225
19416,8,45,61,13,12,0,0,131,273
77541,17,48,149,3,198,18,8,424,110
22228,9,32,76,1,227,13,4,353,297
7767,5,103,211,8,39,6,13,380,246
74564,16,90,191,1,37,4,13,336,106
122582,30,52,45,1,111,1,7,217,216
124942,30,65,107,3,36,1,10,222,221
84920,19,132,195,7,105,4,2,445,119
45147,13,87,18,2,29,1,5,142,31
110534,27,108,5,0,186,0,5,304,195
77229,17,45,136,2,195,21,4,403,109
113480,28,70,175,3,92,6,6,352,202
106396,25,59,111,2,161,12,7,352,185
108271,26,30,150,2,78,6,9,275,190
117869,30,93,165,0,120,2,9,389,223
30443,9,39,144,1,191,23,5,403,290
21465,9,25,63,0,265,11,11,375,295
80069,18,83,99,1,76,11,4,274,116
100422,24,26,86,0,26,1,12,151,174
64688,15,61,111,5,182,17,20,396,71
11630,7,73,113,6,99,2,5,298,259
17893,8,79,359,4,46,8,9,505,270
34344,11,64,264,2,21,0,10,361,8
21637,9,33,146,2,248,26,10,465,296
74464,16,18,10,2,95,1,6,132,106
5,1,64,174,9,32,7,11,297,1
88380,20,184,20,0,158,6,9,377,145
34553,11,232,67,0,12,0,19,330,8
28077,9,42,80,4,308,17,4,455,283
52159,14,60,187,4,78,15,14,358,40
47090,13,102,130,8,142,19,19,420,36
28202,9,24,63,1,245,9,5,347,284
112477,28,71,180,2,103,4,7,367,200
25149,9,63,117,2,291,17,0,490,277
84538,19,45,314,1,62,7,3,432,118
53972,14,42,52,1,8,0,4,107,44
48197,14,95,92,13,125,26,12,363,38
58401,15,41,99,3,106,21,6,276,94
58955,15,65,134,8,144,12,7,370,95
57931,15,35,50,3,171,3,7,269,92
68671,15,83,106,1,236,32,10,468,83
88849,20,54,100,0,160,5,13,332,146
81981,19,67,202,3,52,8,4,336,123
129600,32,34,33,1,19,3,3,93,239
101068,24,58,155,2,83,11,9,318,175
21426,9,39,69,1,298,15,10,432,295
76609,16,53,37,3,153,0,15,261,100
119485,30,129,32,0,186,4,6,357,229
94497,21,45,233,1,144,10,8,441,151
104850,25,60,162,8,128,10,10,378,182
99773,24,80,169,4,55,18,18,344,172
130211,32,57,52,3,99,13,12,236,240
30656,9,26,143,3,160,13,8,353,290
86211,20,70,1,1,27,1,4,104,140
16737,8,72,73,6,47,4,4,206,268
42342,12,55,34,2,148,6,15,260,25
78664,17,3,36,1,54,2,0,96,113
122178,30,50,148,0,97,8,11,314,215
105038,25,47,37,0,16,1,1,102,183
48333,14,62,40,0,18,0,1,121,38
6265,4,63,58,4,102,0,14,241,243
64196,15,28,253,1,90,8,4,384,70
60434,15,42,164,6,208,14,2,436,60
48786,14,111,220,2,17,4,13,367,50
101881,24,50,61,1,153,2,21,288,177
47799,13,63,121,5,177,15,16,397,37
98117,23,90,74,1,144,5,5,319,168
111582,27,154,8,1,246,3,1,413,198
116163,29,77,132,0,59,3,16,287,207
18923,8,71,104,1,26,4,14,220,272
75823,16,35,154,8,109,1,12,319,98
13873,7,52,47,0,159,2,15,275,254
36173,11,58,257,2,35,13,10,375,17
101720,24,133,45,1,229,3,35,446,177
67804,15,38,45,6,131,9,7,236,81
28515,9,34,40,1,277,8,2,362,284
80918,19,120,171,7,51,11,9,369,121
119524,30,43,50,1,97,1,9,201,229
62275,15,90,138,2,180,18,7,435,64
20288,9,37,78,1,163,11,5,295,285
82940,19,125,230,9,79,15,8,466,126
11468,7,206,4,2,92,1,18,323,258
80001,18,58,48,3,75,2,6,192,116
47503,13,49,84,5,149,14,10,311,37
33768,10,75,174,2,68,19,16,354,7
28052,9,49,53,3,294,16,11,426,283
116334,29,18,133,2,134,6,4,297,208
44062,12,45,8,1,91,0,13,158,29
76326,16,41,43,0,82,1,2,169,99
109807,27,57,6,0,116,1,2,182,193
115450,28,51,188,2,67,8,10,326,206
1560,2,59,65,4,58,4,7,197,129
106524,26,57,198,1,60,7,7,330,186
100237,24,101,184,1,39,3,33,361,173
70051,15,65,56,1,88,4,11,225,86
126241,31,167,154,2,10,0,6,339,233
44583,12,60,48,1,164,4,9,286,30
37754,11,41,239,4,52,4,6,346,21
71959,16,10,20,1,126,2,5,164,97
124830,30,49,77,0,35,3,6,170,221
4641,2,54,122,1,74,9,4,264,136
45937,13,133,112,7,133,10,10,405,33
7229,5,62,32,0,103,6,10,213,245
1120,1,93,133,6,71,11,1,315,3
28788,9,29,99,1,222,18,1,370,286
78297,17,48,71,21,181,5,13,339,112
82458,19,101,222,9,76,21,8,437,124
91474,21,86,104,7,105,4,16,322,158
51565,14,51,219,6,83,13,7,379,56
17200,8,69,61,0,33,1,4,168,269
116784,29,44,105,2,142,16,7,316,209
69156,15,78,200,3,80,19,11,391,84
111385,27,129,9,2,285,0,6,431,197
16875,8,54,122,3,58,3,5,245,269
65038,15,139,133,3,153,5,20,453,72
8036,5,142,62,2,47,9,15,277,247
20313,9,38,53,0,166,12,4,273,285
39747,11,43,178,6,100,11,7,345,12
11350,7,141,1,0,45,1,11,199,258
15075,8,64,53,3,39,4,9,172,265
86688,20,85,41,1,153,4,9,293,141
105721,25,42,74,3,93,3,3,218,184
74685,16,77,128,1,66,10,6,288,106
28288,9,31,77,2,233,4,10,357,284
119909,30,55,85,0,17,0,3,160,230
9399,5,129,118,6,71,12,16,352,250
44152,12,215,5,0,130,0,3,353,29
44192,12,34,28,2,109,0,12,185,29
7437,5,41,95,2,90,3,3,234,246
79672,18,128,87,6,215,10,0,446,115
73460,16,49,168,1,65,4,8,295,104
42951,12,158,19,0,161,0,12,350,26
16296,8,85,116,1,53,0,6,261,267
47739,13,43,109,3,221,16,14,406,37
101296,24,50,217,0,89,15,4,375,176
73144,16,32,65,1,74,2,1,175,103
29687,9,28,18,3,266,13,10,338,288
52375,14,88,172,4,48,13,9,334,40
71321,15,40,47,6,134,3,13,243,91
96235,22,79,136,2,98,6,13,334,164
127180,31,84,146,1,62,19,10,322,235
5896,4,23,1,0,36,0,1,61,242
20792,9,24,163,0,95,10,0,292,294
24103,9,29,146,3,253,12,8,451,275
36040,11,47,281,1,19,5,16,369,17
108464,26,58,150,0,37,3,4,252,190
97099,22,77,242,1,131,21,11,483,166
47425,13,81,195,2,193,15,10,496,36
26692,9,32,181,2,242,20,11,488,280
25505,9,40,108,3,296,14,6,467,278
121686,30,58,72,2,210,6,21,369,214
80778,19,78,204,22,54,14,4,376,117
83037,19,75,105,4,55,8,12,259,126
79144,18,87,28,2,58,1,7,183,114
130194,32,73,193,4,143,13,15,441,240
120667,30,64,123,2,171,23,12,395,232
25739,9,30,114,3,259,8,6,420,278
90185,21,29,39,2,190,3,6,269,148
11929,7,235,3,0,24,0,0,262,260
120936,30,51,91,7,125,11,14,299,213
90661,21,70,184,3,219,24,8,508,156
29967,9,21,73,0,250,13,3,360,289
22301,9,33,100,1,305,16,7,462,297
2387,2,61,135,3,34,4,5,242,131
113543,28,70,207,1,65,6,8,357,202
105606,25,54,81,1,113,5,8,262,184
40929,12,92,21,1,115,3,5,237,23
15386,8,60,57,1,53,4,3,178,265
35005,11,58,370,3,44,16,12,503,15
21659,9,36,123,3,296,21,8,487,296
37537,11,18,191,3,8,2,3,225,20
25101,9,17,61,2,193,12,8,293,277
41816,12,44,55,2,164,5,10,280,24
73206,16,46,260,1,66,6,15,394,103
123445,30,43,197,0,113,17,2,372,218
16704,8,87,68,4,31,4,8,202,268
128758,32,42,72,3,95,3,11,226,238
111987,28,77,157,1,49,6,3,293,199
96870,22,60,184,3,76,6,6,335,165
35795,11,140,79,8,46,3,14,290,16
67589,15,58,53,4,135,13,7,270,80
16055,8,72,153,10,77,9,5,326,267
30396,9,30,190,3,196,27,2,448,290
66825,15,70,160,2,242,27,11,512,77
25155,9,19,98,0,202,24,7,350,277
59896,15,69,67,1,232,16,14,399,58
26509,9,24,215,2,138,12,3,394,280
1955,2,43,122,3,59,7,12,246,130
84951,19,161,95,3,61,14,12,346,119
54446,14,117,157,5,55,12,9,355,45
127947,31,115,152,5,31,5,15,323,236
114541,28,141,138,1,20,1,13,314,204
66921,15,61,65,2,156,9,4,297,77
56631,15,79,143,1,120,14,11,368,68
94628,21,40,122,2,102,17,8,291,152
82637,19,99,212,10,74,9,7,411,125
7884,5,112,107,4,49,13,13,298,247
50595,14,92,157,6,39,19,3,316,54
31031,9,32,57,0,381,15,9,494,291
42623,12,7,9,0,34,0,1,51,26
104957,25,49,72,0,29,4,7,161,183
79543,18,102,30,3,95,7,8,245,115
97276,22,75,217,6,89,7,6,400,166
53233,14,55,221,1,73,21,9,380,42
130728,32,99,26,3,102,2,1,233,241
89176,20,80,40,1,90,4,17,232,147
102513,25,34,35,0,7,0,0,76,178
56090,15,109,186,4,104,12,9,424,57
114843,28,127,33,2,61,0,2,225,204
17480,8,76,68,2,23,5,10,184,270
96525,22,52,73,2,55,2,8,192,165
8535,5,105,143,0,109,7,12,376,248
40457,12,80,24,3,169,1,2,279,22
67524,15,36,68,5,136,15,7,267,80
113863,28,69,122,3,96,4,15,309,202
63850,15,26,145,3,159,13,1,347,69
88168,20,128,62,0,39,3,10,242,145
66383,15,69,119,3,119,14,18,342,76
105942,25,39,128,1,94,5,7,274,185
81936,19,84,170,7,58,7,12,338,123
110248,27,124,1,0,218,0,8,351,195
130127,32,74,139,7,189,19,30,458,240
74836,16,39,103,3,171,7,9,332,107
94651,21,31,136,5,106,20,7,305,152
60556,15,215,65,2,140,1,3,426,60
123691,30,77,108,3,152,22,15,377,219
67883,15,44,61,3,206,5,4,323,81
48813,14,88,231,5,30,7,8,369,50
61819,15,49,398,1,105,24,8,585,63
117059,30,86,109,4,157,3,8,367,212
62698,15,52,122,4,246,20,10,454,65
33164,10,70,148,13,66,7,12,316,6
76343,16,30,29,0,123,0,6,188,99
71816,16,39,21,1,212,4,9,286,97
26200,9,50,213,3,187,20,22,495,280
32631,10,113,167,3,104,10,3,400,5
111686,27,144,8,1,162,0,10,325,198
116341,29,60,106,1,187,6,11,371,208
26875,9,16,60,1,259,16,0,352,281
47105,13,76,123,9,178,18,12,416,36
100308,24,102,133,0,47,1,16,299,173
115911,29,53,104,1,119,7,24,308,207
2800,2,50,141,3,57,16,7,274,132
116096,29,47,188,2,144,11,23,415,207
123,1,129,136,3,37,2,19,326,1
104364,25,29,100,6,89,6,8,238,182
38987,11,77,147,0,69,5,5,303,10
108378,26,53,138,0,64,10,7,272,190
48240,14,41,61,3,69,17,17,208,38
61742,15,30,241,3,129,27,3,433,63
3443,2,60,133,60,68,22,2,345,134
71153,15,58,67,0,190,26,10,351,89
48768,14,46,227,4,39,5,11,332,50
71002,15,63,64,5,219,18,16,385,89
53534,14,104,252,4,158,18,6,542,43
110389,27,160,6,1,280,0,6,453,195
89106,20,59,83,2,187,14,9,354,147
22320,9,45,57,3,286,14,8,413,297
18188,8,31,103,6,82,8,0,230,271
56871,15,137,54,4,81,10,13,299,79
28479,9,30,40,4,295,9,3,381,284
62800,15,44,145,4,162,25,3,383,65
26601,9,33,217,2,170,12,6,440,280
36751,11,52,212,0,17,5,10,296,18
77143,17,20,156,0,88,15,4,283,109
50622,14,118,181,6,66,22,10,403,54
15143,8,109,101,6,38,16,14,284,265
26811,9,40,107,4,291,21,15,478,281
65183,15,78,90,5,179,13,7,372,73
97341,22,131,147,1,51,5,14,349,166
106024,25,42,49,4,48,4,3,150,185
74627,16,64,198,4,103,10,6,385,106
84755,19,90,159,7,40,9,6,311,119
20005,9,97,130,4,381,16,0,628,274
108465,26,88,372,5,116,17,6,604,190
5811,4,61,82,15,115,4,7,284,242
91034,21,97,198,2,62,2,22,383,157
95824,21,149,91,4,119,6,22,391,155
112266,28,86,135,5,79,17,10,332,199
114211,28,103,160,14,124,9,14,424,203
128382,31,181,196,1,25,7,21,431,237
69583,15,15,39,1,53,2,4,114,85
75346,16,41,210,0,134,21,4,410,108
95715,21,40,30,1,87,3,1,162,154
62034,15,79,62,7,212,18,23,401,64
50108,14,114,63,3,23,4,9,216,53
85872,20,216,46,0,140,0,9,411,137
86548,20,80,31,3,188,5,7,314,141
41661,12,9,1,1,33,0,0,44,24
77335,17,32,122,4,183,15,4,360,109
6855,5,112,104,4,191,12,9,432,245
68980,15,53,231,6,76,16,5,387,84
55578,14,36,141,1,63,6,2,249,48
54908,14,53,142,5,117,5,13,335,46
36290,11,65,252,3,31,12,20,383,17
18201,8,91,66,2,84,7,7,257,271
37582,11,25,244,4,33,2,7,315,20
129155,32,39,84,10,52,11,17,213,239
106485,26,36,134,1,68,6,1,246,186
26204,9,25,171,1,162,13,3,375,280
9770,6,76,163,2,109,7,11,368,251
115932,29,24,29,0,51,0,5,109,207
69807,15,105,57,5,103,5,7,282,86
107332,26,53,211,8,78,6,4,360,188
117964,30,70,66,8,99,6,10,259,226
58139,15,58,162,3,182,27,4,436,93
65061,15,59,88,0,73,1,9,230,72
19690,8,14,13,2,1,0,1,31,273
97881,23,68,64,2,206,2,7,349,168
68024,15,40,63,3,162,17,9,294,81
41106,12,58,57,5,163,11,6,300,23
94078,21,58,182,0,111,25,10,386,150
120702,30,80,107,1,58,11,9,266,232
95797,21,141,13,0,26,1,6,187,155
65680,15,60,55,3,158,18,5,299,74
85553,20,79,44,24,117,6,13,283,137
27443,9,16,188,0,124,16,3,347,282
37777,11,42,236,2,39,9,2,330,21
68631,15,74,55,5,176,31,10,351,83
70768,15,81,31,5,227,9,10,363,88
4888,3,39,54,0,104,6,9,212,210
114372,28,106,89,2,41,2,15,255,203
37939,11,64,173,3,41,5,8,294,21
72193,16,79,69,2,128,5,4,287,101
64981,15,79,182,5,180,15,9,470,72
58011,15,51,164,5,155,23,3,401,93
74172,16,14,22,3,183,0,8,230,105
109989,27,58,6,2,243,1,4,314,194
3845,2,48,184,2,73,4,3,314,134
37234,11,59,254,2,51,7,11,384,19
44132,12,20,16,3,27,1,2,69,29
109267,26,67,120,8,125,8,4,332,192
31643,9,36,64,0,303,18,11,432,293
22151,9,16,60,2,206,1,9,294,297
62830,15,107,106,2,181,10,7,413,66
14996,7,81,89,1,106,2,13,292,256
83739,19,48,59,2,42,4,4,159,128
36625,11,81,270,6,47,19,11,434,18
117538,30,86,61,7,160,3,15,332,223
6522,5,85,158,5,45,4,4,301,244
130444,32,62,65,7,97,2,8,241,241
32582,10,110,168,0,90,9,6,383,5
84139,19,100,141,0,56,5,21,323,128
112657,28,72,190,2,114,3,10,391,200
67793,15,44,55,3,178,18,10,308,81
52301,14,111,210,8,110,29,13,481,40
71338,15,30,57,5,277,9,5,383,91
91618,21,45,195,3,82,4,6,335,159
21945,9,47,247,1,72,10,4,381,296
23051,9,34,117,10,272,13,1,447,299
55292,14,75,155,5,164,11,7,417,47
87550,20,35,39,0,62,3,8,147,144
49248,14,90,266,12,99,31,7,505,51
52780,14,123,152,8,61,23,12,379,41
107833,26,56,96,2,21,1,7,183,189
16876,8,63,91,2,62,10,6,234,269
68808,15,104,73,3,206,22,10,418,83
112162,28,37,160,3,38,8,3,249,199
36463,11,42,382,1,46,10,4,485,18
18988,8,76,164,6,38,12,8,304,272
98749,23,50,66,3,125,9,2,255,170
52344,14,107,132,4,126,20,6,395,40
72209,16,14,106,1,52,4,8,185,101
110820,27,215,15,0,266,4,0,500,196
108910,26,45,171,4,127,19,1,367,191
31563,9,18,143,2,246,13,7,429,292
109312,26,47,103,4,109,5,6,274,192
81728,19,46,254,5,58,11,6,380,123
105688,25,31,119,1,89,8,2,250,184
93800,21,50,149,7,82,5,13,306,150
24325,9,70,114,5,304,12,10,515,275
53806,14,62,230,2,16,6,15,331,44
129087,32,24,42,1,25,3,0,95,239
3312,2,51,150,3,64,7,6,281,133
103696,25,78,150,0,108,10,3,349,180
37841,11,38,297,1,54,14,6,410,21
28460,9,17,40,0,253,8,3,321,284
51669,14,84,258,3,69,16,11,441,39
122201,30,96,232,3,115,22,1,469,215
7703,5,81,193,4,45,19,12,354,246
77532,17,44,131,6,173,15,4,373,110
92301,21,79,152,6,113,13,20,383,160
59493,15,57,61,8,263,20,11,420,58
124623,30,45,105,3,185,7,11,356,221
62180,15,75,67,5,214,16,15,392,64
29535,9,37,74,4,230,15,6,366,288
45930,13,95,70,3,146,6,7,327,33
129103,32,63,95,9,88,10,20,285,239
103793,25,74,71,0,80,16,4,245,180
129945,32,85,215,1,127,7,5,440,240
77663,17,35,121,7,154,7,0,324,110
71192,15,64,51,4,208,14,14,355,89
80234,18,51,58,0,100,8,5,222,116
16164,8,52,186,5,69,12,8,332,267
122113,30,83,116,1,63,10,9,282,215
16745,8,132,112,6,65,8,13,336,268
29963,9,37,61,1,215,11,9,334,289
99757,24,52,236,6,100,25,10,429,172
113198,28,98,106,1,153,14,8,380,201
120343,30,60,49,3,40,1,5,158,231
102702,25,29,57,0,19,0,2,107,178
36959,11,43,125,2,44,1,3,218,19
101799,24,38,83,0,78,0,20,219,177
125118,30,57,103,0,72,6,8,246,222
46019,13,114,14,2,43,0,6,179,33
103203,25,125,177,0,64,2,9,377,179
94783,21,86,71,3,23,1,6,190,152
57418,15,132,86,7,122,21,6,374,90
41019,12,88,88,7,182,16,0,381,23
108636,26,19,138,0,32,8,0,197,191
111395,27,146,20,1,189,2,6,364,198
49789,14,62,176,0,65,9,1,313,52
34861,11,50,188,16,31,54,11,350,14
72323,16,56,143,3,83,3,8,296,101
89358,20,99,88,4,92,6,0,289,138
103100,25,107,73,1,104,4,6,295,179
86506,20,25,8,2,28,1,4,68,141
50120,14,81,281,7,97,18,8,492,53
117875,30,85,150,0,41,1,1,278,223
100033,24,136,84,0,18,2,17,257,173
12763,7,47,99,0,156,2,3,307,262
23722,9,27,116,3,184,13,8,351,300
13824,7,71,63,0,159,2,9,304,264
77000,17,41,177,6,171,13,5,413,109
49021,14,72,243,0,23,9,8,355,50
22198,9,38,106,1,304,22,10,481,297
31800,9,18,50,0,248,9,4,329,293
99403,24,81,28,0,28,3,28,168,171
62490,15,35,56,1,194,14,4,304,65
115113,28,70,157,2,69,7,17,322,205
81939,19,60,198,2,44,13,5,322,123
25857,9,18,80,5,392,15,2,512,279
74266,16,21,71,11,78,3,13,197,105
64944,15,71,69,4,262,0,10,416,72
51153,14,113,203,2,97,15,10,440,55
99376,24,194,86,7,55,5,28,375,171
14326,7,80,64,2,130,3,6,285,255
99294,24,72,164,10,66,7,16,335,171
112467,28,34,79,2,49,1,12,177,200
100780,24,37,93,0,109,2,20,261,174
123441,30,26,112,2,112,7,6,265,218
55451,14,162,158,14,69,7,12,422,47
35982,11,44,202,2,26,9,5,288,17
1923,2,89,169,7,79,17,11,372,130
98584,23,127,118,3,98,11,18,375,169
49956,14,139,153,1,52,2,0,347,52
54530,14,121,207,10,79,23,9,449,45
55577,14,108,370,4,224,18,17,741,48
59912,15,54,140,1,174,19,4,392,59
52784,14,78,136,3,68,10,8,303,41
128877,32,89,40,0,28,5,7,169,238
23132,9,51,92,5,206,13,4,371,299
114160,28,108,127,6,159,8,7,415,203
58504,15,50,219,2,121,18,6,416,94
70089,15,73,1,0,61,1,2,138,86
55667,14,159,52,23,123,0,8,365,48
91340,21,135,93,37,46,2,42,355,158
2114,2,19,135,3,59,16,3,235,131
91817,21,71,126,1,134,15,9,356,159
1274,2,44,142,4,55,12,10,267,129
60555,15,188,85,3,156,3,13,448,60
8568,5,81,142,2,107,7,11,350,248
19942,9,42,85,4,357,23,7,518,274
90127,21,88,110,5,175,8,15,401,148
86761,20,65,124,2,184,9,11,395,142
37586,11,47,279,5,25,2,17,375,20
116012,29,20,87,0,103,1,7,218,207
63085,15,108,178,6,134,24,8,458,66
6375,5,85,130,4,57,9,2,287,244
13006,7,46,38,1,168,4,23,280,262
35150,11,53,330,4,46,13,8,454,15
85860,20,161,88,0,46,2,7,304,137
38925,11,41,130,1,31,6,9,218,10
86156,20,84,26,1,76,0,47,234,140
84723,19,89,170,3,63,17,11,353,119
47676,13,74,51,5,142,2,7,281,37
41190,12,16,1,0,22,0,0,39,23
100032,24,138,91,2,31,1,26,289,173
92022,21,48,178,3,130,16,6,381,160
26822,9,26,105,1,296,15,16,459,281
67384,15,64,64,8,172,17,6,331,80
26474,9,27,178,2,163,13,6,389,280
50586,14,108,175,5,85,18,8,399,54
88297,20,3,3,1,94,0,1,102,145
119987,30,95,139,1,83,7,24,349,230
46178,13,90,69,10,115,11,5,300,33
85901,20,0,6,0,2,0,0,8,140
22645,9,34,170,1,199,17,5,426,298
36536,11,26,302,1,27,17,1,374,18
72760,16,98,207,4,95,19,0,423,102
101343,24,32,184,3,60,12,9,300,176
91656,21,97,78,6,101,7,7,296,159
117383,30,54,32,0,137,1,18,242,212
58805,15,96,109,4,167,11,11,398,95
123243,30,130,52,0,101,11,30,324,218
127929,31,123,113,4,51,8,9,308,236
89380,20,54,20,0,0,0,22,96,138
69927,15,120,41,0,108,0,8,277,86
94195,21,66,294,1,120,14,8,503,151
67598,15,47,63,4,175,9,3,301,80
49975,14,171,196,3,37,3,17,427,52
82775,19,60,258,3,55,12,3,391,125
115478,28,41,143,3,47,5,8,247,206
75120,16,46,70,1,68,3,10,198,107
11277,7,151,15,0,8,0,8,182,258
111514,27,150,46,0,241,5,3,445,198
78809,17,37,83,6,99,14,18,257,113
63698,15,49,201,2,217,31,10,510,69
68839,15,82,86,6,171,18,12,375,83
41380,12,53,46,2,287,2,12,402,23
110617,27,129,15,0,162,0,5,311,196
31609,9,23,194,0,199,12,11,439,292
87200,20,166,9,0,132,0,9,316,143
5005,3,48,88,6,120,7,2,271,210
44049,12,35,0,0,65,0,2,102,29
30485,9,37,259,2,106,16,3,423,290
112016,28,31,47,1,45,3,4,131,199
110725,27,165,13,1,184,3,5,371,196
87449,20,186,8,1,188,3,5,391,143
126952,31,142,193,3,65,3,15,421,234
47804,13,74,129,7,190,20,2,422,37
108825,26,25,79,3,89,10,10,216,191
14321,7,99,41,1,129,3,14,287,255
32912,10,104,95,0,95,14,7,315,5
57918,15,85,69,6,209,16,13,398,92
123810,30,54,158,1,92,10,5,320,219
824,1,60,184,11,58,28,8,349,3
98547,23,71,64,19,80,4,4,242,169
67584,15,71,92,8,189,26,9,395,80
120776,30,160,106,4,86,8,19,383,232
119286,30,70,66,0,133,4,10,283,229
99988,24,16,20,0,18,0,3,57,173
46834,13,87,133,4,205,16,11,456,35
89944,20,98,24,0,222,5,9,358,139
67740,15,38,64,3,166,12,12,295,80
37545,11,5,300,40,23,1,0,369,20
55204,14,57,104,0,26,3,4,194,47
74882,16,28,137,0,93,6,1,265,107
127342,31,74,193,2,56,9,9,343,235
83926,19,12,31,1,5,0,2,51,128
21017,9,63,154,2,291,19,12,541,294
126029,30,68,81,0,211,4,10,374,225
3630,2,50,68,7,59,3,4,191,134
104367,25,79,111,5,104,1,9,309,182
61217,15,49,138,2,170,17,10,386,62
67868,15,31,53,4,205,15,3,311,81
87732,20,79,5,0,112,0,6,202,144
33830,10,85,186,2,71,5,8,357,7
4506,2,49,144,2,64,9,6,274,136
40755,12,56,37,0,192,2,19,306,22
54822,14,82,195,3,121,6,7,414,46
47111,13,65,102,6,119,14,11,317,36
66913,15,55,74,11,204,15,6,365,77
27431,9,14,79,0,170,9,4,276,282
77350,17,34,168,2,111,9,7,331,109
114952,28,97,208,2,43,0,10,360,205
115232,28,67,197,1,90,8,7,370,205
77408,17,46,162,3,113,12,3,339,109
27100,9,32,82,1,233,15,5,368,281
45606,13,82,23,4,94,1,11,215,32
37562,11,42,164,5,12,5,20,248,20
38627,11,73,189,5,35,8,16,326,9
75103,16,15,73,0,95,6,8,197,107
89454,20,143,20,0,107,1,52,323,138
110432,27,138,14,1,168,0,11,332,195
102329,25,28,20,2,28,0,2,80,178
85182,19,180,142,4,90,5,12,433,120
93221,21,88,176,4,141,21,12,442,163
52676,14,69,210,7,70,5,9,370,41
101041,24,44,187,3,67,22,6,329,175
73766,16,31,184,1,48,4,3,271,104
86202,20,79,11,0,20,0,13,123,140
46859,13,124,71,0,168,5,6,374,35
93030,21,69,199,3,134,19,9,433,163
50893,14,70,217,4,69,13,9,382,55
14787,7,45,63,0,93,9,13,223,256
53382,14,61,329,5,73,17,4,489,43
128718,32,82,47,5,115,4,12,265,238
18948,8,87,322,4,61,18,6,498,272
97265,22,56,133,5,67,8,19,288,166
100524,24,40,207,0,112,10,5,374,174
61732,15,40,417,1,82,8,1,549,63
65826,15,76,43,4,140,7,8,278,74
51696,14,50,343,1,75,13,2,484,39
88150,20,191,62,0,135,0,12,400,145
104799,25,53,111,5,65,3,13,250,182
558,1,91,146,5,99,13,6,360,2
11847,7,79,30,2,91,0,1,203,259
22970,9,37,119,2,166,17,5,346,299
125272,30,61,69,0,43,2,6,181,222
127116,31,76,240,1,44,7,6,374,235
45038,13,96,62,3,102,4,27,294,31
18294,8,141,158,5,78,7,4,393,271
13732,7,43,53,3,173,0,9,281,264
26540,9,42,150,0,171,17,3,383,280
83210,19,105,158,3,68,4,8,346,126
33362,10,32,65,0,136,0,7,240,6
79086,18,120,49,0,60,2,5,236,114
115974,29,43,187,4,140,8,12,394,207
93636,21,101,165,2,128,15,10,421,149
83152,19,38,95,3,28,3,4,171,126
110893,27,39,1,0,476,0,13,529,196
76348,16,28,73,1,188,0,4,294,99
80860,19,77,213,6,79,8,7,390,117
95528,21,71,218,0,131,11,5,436,154
17941,8,96,202,4,72,13,9,396,270
120707,30,59,163,2,48,7,28,307,232
34405,11,54,86,1,68,7,12,228,8
84491,19,179,119,6,33,15,15,367,118
1054,1,85,152,5,69,27,13,351,3
67892,15,70,81,2,193,16,9,371,81
13210,7,28,23,0,168,5,16,240,263
46072,13,52,110,1,120,11,7,301,33
30397,9,34,131,5,282,21,4,477,290
13456,7,48,69,5,192,7,19,340,264
92631,21,28,111,3,112,9,10,273,161
8894,5,75,223,0,115,16,4,433,249
4029,2,44,111,1,55,8,11,230,135
115485,28,96,166,3,76,6,18,365,206
91775,21,73,152,1,94,9,7,336,159
81287,19,128,114,6,73,12,17,350,122
107106,26,54,100,0,52,5,4,215,187
128118,31,171,73,1,125,3,12,385,237
37431,11,52,220,3,40,4,9,328,20
7421,5,76,45,0,23,1,0,145,246
20456,9,33,154,3,226,13,9,438,285
54009,14,97,116,13,47,0,11,284,44
117176,30,62,68,2,104,4,10,250,212
15775,8,75,54,1,21,5,8,164,266
14029,7,84,17,0,129,0,16,246,254
31126,9,41,56,0,287,14,12,410,292
46792,13,129,159,3,155,4,14,464,35
127220,31,76,121,3,53,5,9,267,235
73063,16,38,115,8,127,0,5,293,103
39480,11,44,61,1,8,2,7,123,11
63297,15,62,110,7,200,17,3,399,67
113068,28,54,188,0,91,9,10,352,201
129328,32,77,103,3,30,7,12,232,239
50113,14,62,113,4,22,6,5,212,53
23909,9,38,244,2,43,9,2,338,275
46852,13,119,89,6,143,9,14,380,35
111921,28,103,109,2,56,6,7,283,199
130411,32,22,20,2,84,1,10,139,241
68573,15,46,57,7,185,1,8,304,83
58300,15,59,109,3,198,21,10,400,93
87655,20,79,23,2,121,3,24,252,144
95854,21,51,30,0,23,0,7,111,155
85164,19,133,162,1,27,1,9,333,120
73464,16,63,204,2,56,2,9,336,104
36191,11,90,279,5,36,7,13,430,17
115102,28,73,144,1,69,14,20,321,205
4348,2,87,433,2,206,12,19,759,136
6772,5,118,158,6,24,2,8,316,244
81972,19,64,196,7,58,14,7,346,123
81313,19,128,59,4,42,1,5,239,122
81139,19,137,172,9,74,10,11,413,121
79331,18,78,29,3,59,0,6,175,114
5555,4,77,102,4,130,18,13,344,242
101423,24,28,221,1,67,13,6,336,176
123360,30,35,121,0,111,7,2,276,218
69733,15,126,33,0,173,5,15,352,86
97357,22,75,218,3,94,10,10,410,166
35935,11,47,294,1,23,6,14,385,17
70112,15,114,197,2,98,6,9,426,86
6673,5,59,143,5,48,5,6,266,244
45825,13,101,223,11,392,19,10,756,33
110835,27,151,12,0,181,1,11,356,196
7730,5,41,44,0,18,2,2,107,246
13589,7,54,117,0,209,9,7,396,264
127762,31,52,195,2,69,9,9,336,236
12456,7,92,17,0,161,0,12,282,261
52239,14,81,154,2,83,12,12,344,40
20412,9,52,177,1,230,19,9,488,285
85703,20,51,104,2,107,3,2,269,137
64679,15,51,158,3,114,11,10,347,71
73412,16,74,32,2,70,3,8,189,104
108247,26,73,320,0,54,13,6,466,190
94057,21,61,208,4,111,19,10,413,150
6890,5,84,50,0,139,4,14,291,245
103838,25,56,76,0,48,1,3,184,180
18032,8,137,80,4,116,8,13,358,271
20003,9,39,105,2,303,11,9,469,274
71070,15,73,49,8,250,23,15,418,89
90735,21,52,143,5,93,10,5,308,156
106873,26,97,131,0,51,0,11,290,187
112309,28,50,152,5,87,10,8,312,199
22386,9,27,85,2,128,10,2,254,297
41176,12,54,1,1,37,0,2,95,23
68534,15,66,86,5,208,23,20,408,83
130459,32,42,20,2,71,1,9,145,241
84734,19,154,183,10,54,11,16,428,119
54636,14,33,34,0,6,2,1,76,46
76904,16,101,152,1,95,11,8,368,100
85064,19,111,133,4,112,7,15,382,120
8833,5,66,176,2,110,12,3,369,249
95177,21,60,64,6,132,5,16,283,153
78202,17,73,172,5,125,8,18,401,111
10389,7,115,37,2,127,3,14,298,253
55836,14,73,25,0,5,1,2,106,48
32812,10,68,90,2,82,6,1,249,5
47753,13,70,108,2,214,17,3,414,37
62413,15,88,75,15,194,16,20,408,64
85968,20,126,18,1,128,0,0,273,140
52463,14,100,125,9,138,6,17,395,41
32453,10,74,75,1,8,0,5,163,4
4612,2,41,107,5,94,9,4,260,136
68596,15,76,129,4,289,29,18,545,83
53190,14,87,256,3,97,31,8,482,42
50971,14,55,153,1,79,16,5,309,55
96974,22,45,185,5,95,10,10,350,166
100839,24,47,158,2,65,7,17,296,175
126031,30,72,89,0,174,4,11,350,225
20949,9,35,96,1,280,19,10,441,294
52905,14,117,133,5,63,19,6,343,42
52919,14,79,191,4,69,15,12,370,42
79697,18,54,80,5,105,10,16,270,115
49002,14,63,215,8,28,15,9,338,50
4954,3,41,15,0,90,2,2,150,210
41656,12,50,4,4,131,0,1,190,24
32189,10,46,86,2,9,1,1,145,4
47048,13,66,99,0,161,13,11,350,35
42991,12,113,28,0,113,0,19,273,26
100126,24,97,84,1,13,2,14,211,173
115334,28,61,67,1,98,7,14,248,205
71972,16,16,10,0,95,0,3,124,97
77626,17,26,132,2,161,18,10,349,110
13419,7,104,14,0,53,0,10,181,263
104419,25,67,115,3,124,2,14,325,182
79022,17,28,130,7,134,12,6,317,113
25847,9,18,71,2,316,19,4,430,279
33346,10,134,108,1,154,5,8,410,6
51294,14,78,186,8,82,13,15,382,56
39085,11,34,280,2,74,18,6,414,11
22790,9,48,125,1,232,17,6,429,298
46231,13,33,13,5,97,1,6,155,33
53937,14,80,87,11,147,11,13,349,44
368,1,3,38,0,2,0,1,44,1
45161,13,115,55,4,177,4,17,372,31
51746,14,96,208,2,87,26,5,424,39
12519,7,115,191,2,173,14,12,507,261
12437,7,59,29,2,134,0,9,233,261
128406,32,60,103,1,69,17,12,262,238
64304,15,46,114,3,172,14,2,351,70
71267,15,60,140,9,90,13,11,323,91
56368,15,86,187,0,32,0,10,315,57
50967,14,63,114,5,44,7,6,239,55
8577,5,57,119,1,85,5,4,271,248
97085,22,37,184,4,59,10,10,304,166
29520,9,24,87,2,317,21,6,457,288
7169,5,111,90,0,61,8,5,275,245
31494,9,31,113,7,221,9,5,386,292
29872,9,20,76,2,330,9,3,440,289
12570,7,56,86,3,97,8,10,260,261
28981,9,39,78,7,320,18,5,467,286
92369,21,28,57,0,142,0,0,227,161
84932,19,137,122,7,67,13,13,359,119
81652,19,176,58,8,77,8,16,343,122
128066,31,117,172,1,16,4,12,322,237
81596,19,61,293,2,44,9,6,415,122
31329,9,51,100,2,367,14,12,546,292
63560,15,43,160,4,217,19,8,451,67
126298,31,52,177,0,1,0,2,232,233
15633,8,20,19,2,16,3,3,63,266
92047,21,31,131,5,129,12,9,317,160
74797,16,43,43,0,220,4,7,317,106
35468,11,74,233,2,85,25,21,440,16
43413,12,43,43,2,101,5,6,200,27
105055,25,82,13,0,9,1,3,108,183
122135,30,74,132,1,70,19,7,303,215
34906,11,23,325,3,36,2,11,400,14
18728,8,115,173,19,68,9,8,392,272
25727,9,35,105,2,297,23,7,469,278
65405,15,66,90,5,233,12,9,415,73
34102,10,68,235,4,94,12,8,421,7
107498,26,63,220,3,64,9,5,364,188
111584,27,123,13,2,253,0,2,393,198
2051,2,85,128,2,93,14,12,334,130
43395,12,36,1,0,39,0,2,78,27
87586,20,18,1,0,35,0,2,56,144
63779,15,55,61,4,241,17,7,385,69
48168,14,73,95,5,19,1,4,197,38
53158,14,122,126,4,55,12,14,333,42
79278,18,143,45,3,224,9,11,435,114
74282,16,48,176,0,106,7,7,344,105
115291,28,82,200,9,106,18,15,430,205
9076,5,47,223,1,91,19,7,388,249
128121,31,146,77,2,175,1,7,408,237
60273,15,47,136,0,220,23,10,436,59
91066,21,67,153,6,107,16,20,369,157
38237,11,48,157,3,46,6,6,266,9
44613,12,46,44,5,180,14,7,296,30
51387,14,141,147,4,59,14,18,383,56
31697,9,22,86,2,308,15,4,437,293
98585,23,99,110,4,80,9,15,317,169
122866,30,46,46,0,71,0,8,171,217
55604,14,72,240,3,110,15,5,445,48
37799,11,57,190,2,42,2,13,306,21
76412,16,47,138,4,157,8,4,358,99
24229,9,19,146,2,105,15,6,293,275
28558,9,21,52,1,259,9,6,348,286
18370,8,20,3,1,14,2,0,40,271
127571,31,64,254,2,63,8,6,397,236
81583,19,39,136,6,30,4,6,221,122
66039,15,138,178,4,78,4,21,423,75
51014,14,128,176,2,74,21,8,409,55
67327,15,54,96,2,163,12,5,332,78
3653,2,58,66,5,44,7,5,185,134
51808,14,117,185,6,67,12,7,394,39
65766,15,107,70,5,195,10,19,406,74
109813,27,81,14,0,204,2,4,305,194
75825,16,53,141,3,137,11,7,352,98
71042,15,96,73,4,218,17,14,422,89
85198,19,144,70,16,128,1,15,374,120
2156,2,29,158,5,67,14,9,282,131
82862,19,62,256,2,43,11,5,379,126
98050,23,130,199,1,88,7,1,426,168
33288,10,66,62,0,8,0,3,139,6
121456,30,60,132,0,135,6,7,340,214
96000,21,90,127,5,169,14,6,411,155
99931,24,52,73,5,54,6,12,202,173
6708,5,74,143,4,36,4,9,270,244
124038,30,117,163,3,152,8,9,452,219
60523,15,73,54,1,176,17,4,325,60
67216,15,59,125,6,250,21,5,466,78
35106,11,56,202,3,43,15,18,337,15
78597,17,49,99,1,229,3,27,408,112
108250,26,33,285,0,58,7,1,384,190
116370,29,22,63,1,144,13,7,250,208
120234,30,68,195,0,158,15,1,437,231
63459,15,55,99,2,107,14,5,282,67
65014,15,63,98,5,126,6,6,304,72
103058,25,97,115,2,144,6,11,375,179
94392,21,71,160,5,142,17,16,411,151
50593,14,92,168,1,56,12,7,336,54
103171,25,56,73,0,88,6,3,226,179
81556,19,51,114,4,43,7,3,222,122
55603,14,60,223,3,95,9,2,392,48
108748,26,34,164,0,120,18,6,342,191
117798,30,78,134,0,74,4,5,295,223
46865,13,55,82,7,176,7,1,328,35
68208,15,34,53,3,179,14,18,301,82
130781,32,13,17,0,47,1,7,85,241
60934,15,58,190,3,205,11,8,475,61
98304,23,167,30,3,151,0,8,359,169
118940,30,71,131,1,131,8,5,347,228
63317,15,41,229,4,155,30,0,459,67
29378,9,19,77,1,255,19,6,377,288
87668,20,54,15,1,130,2,13,215,144
82704,19,88,189,5,49,13,5,349,125
104887,25,83,99,3,91,7,16,299,182
899,1,58,233,2,81,17,7,398,3
83304,19,123,184,1,64,18,13,403,127
53505,14,89,167,6,67,18,15,362,43
30552,9,34,131,2,282,21,1,471,290
114636,28,56,92,0,131,4,7,290,204
55782,14,103,151,4,62,10,1,331,48
98993,23,63,125,3,155,12,10,368,170
63587,15,62,129,7,140,16,8,362,67
72363,16,64,49,0,96,1,6,216,101
53818,14,139,166,6,32,2,11,356,44
37963,11,82,251,2,52,6,13,406,21
57528,15,126,94,1,232,19,14,486,92
110070,27,161,10,0,211,2,6,390,194
54498,14,69,185,3,37,5,6,305,45
6251,4,44,128,4,56,4,13,249,243
98504,23,91,82,3,68,15,9,268,169
39330,11,50,208,2,34,9,13,316,11
79366,18,82,23,1,110,2,4,222,114
31220,9,33,144,1,308,19,9,514,292
3155,2,59,202,4,57,11,7,340,133
94415,21,34,203,0,115,19,6,377,151
68872,15,34,69,5,182,13,11,314,83
15381,8,92,133,5,87,14,8,339,265
46051,13,59,129,5,132,13,8,346,33
1161,1,92,209,1,61,16,16,395,3
41963,12,39,14,0,112,1,3,169,24
15029,8,46,17,0,7,1,1,72,265
82166,19,162,101,4,46,4,17,334,124
55640,14,103,152,3,121,20,10,409,48
119805,30,50,132,3,80,1,16,282,230
23520,9,47,67,4,267,12,9,406,300
118624,30,44,105,2,68,5,0,224,227
56738,15,138,64,0,18,0,10,230,68
114428,28,109,99,1,43,1,9,262,204
127126,31,122,73,3,61,14,15,288,235
51432,14,102,217,6,94,22,17,458,56
24220,9,21,231,0,66,3,4,325,275
92592,21,75,134,7,160,11,9,396,161
24110,9,9,163,1,151,10,0,334,275
63680,15,51,157,2,244,20,16,490,69
81650,19,95,41,1,39,2,1,179,122
53314,14,68,201,3,97,22,9,400,42
33396,10,63,91,0,31,5,7,197,6
97407,22,79,208,3,121,9,15,435,167
59462,15,78,140,5,166,6,19,414,96
20828,9,40,106,1,226,18,5,396,294
11249,7,213,35,3,95,2,6,354,258
73911,16,68,91,3,186,4,16,368,105
6049,4,83,105,2,105,4,8,307,243
99393,24,26,23,1,7,0,2,59,171
123071,30,56,36,0,174,0,10,276,217
69555,15,42,143,5,148,17,4,359,85
16052,8,82,219,2,79,10,8,400,267
17229,8,96,110,5,69,2,17,299,269
19586,8,38,125,2,40,3,9,217,273
56862,15,182,85,1,96,4,10,378,79
35674,11,91,222,5,113,25,7,463,16
59937,15,64,71,5,201,16,15,372,59
14047,7,11,16,0,168,2,10,207,254
79300,18,56,46,0,80,3,1,186,114
79004,17,57,120,5,119,10,15,326,113
10015,6,85,112,5,79,8,10,299,252
105562,25,45,68,1,52,1,7,174,184
109164,26,90,87,3,139,0,14,333,192
41653,12,5,0,0,28,0,0,33,24
124120,30,73,91,1,8,0,7,180,220
94893,21,163,75,0,15,0,9,262,152
110003,27,189,12,0,201,2,10,414,194
53187,14,95,180,7,54,13,8,357,42
122308,30,85,129,5,91,4,20,334,216
58215,15,65,88,3,164,17,5,342,93
92454,21,68,173,1,93,11,12,358,161
11793,7,106,28,0,79,2,11,226,259
109204,26,147,103,1,93,4,5,353,192
87004,20,71,93,4,225,14,7,414,142
103060,25,38,47,0,61,6,13,165,179
69500,15,93,41,5,195,4,6,344,85
67154,15,44,102,5,186,19,12,368,78
112433,28,48,127,0,100,3,6,284,200
72523,16,41,158,2,96,1,3,301,102
33837,10,58,196,8,87,8,3,360,7
113949,28,175,132,3,91,1,6,408,203
126153,30,136,99,1,192,3,1,432,225
14897,7,53,48,4,80,2,19,206,256
59719,15,46,125,2,238,23,11,445,58
34060,10,67,239,1,88,15,6,416,7
84280,19,67,161,1,62,7,5,303,118
45233,13,66,76,0,97,1,19,259,31
46061,13,57,87,7,134,6,6,297,33
15094,8,31,7,1,18,0,0,57,265
102902,25,74,121,1,121,8,9,334,179
49410,14,84,166,3,68,13,10,344,51
67722,15,36,79,5,187,13,4,324,80
56308,15,49,76,8,65,4,6,208,57
89992,20,221,12,0,91,5,10,339,139
70003,15,184,87,1,53,6,7,338,86
11320,7,127,1,1,6,0,5,140,258
60514,15,29,65,3,188,8,6,299,60
118557,30,63,206,1,95,19,7,391,227
94187,21,42,222,2,89,10,7,372,151
13748,7,76,99,4,190,11,11,391,264
45471,13,72,71,1,140,6,8,298,32
45251,13,107,34,5,178,2,23,349,31
106575,26,96,137,4,80,10,8,335,186
33021,10,96,172,6,94,2,8,378,5
126593,31,122,149,0,93,0,8,372,233
40376,12,48,7,0,115,0,7,177,22
98313,23,54,13,1,152,0,6,226,169
72360,16,30,9,0,129,1,2,171,101
107247,26,39,199,0,48,3,8,297,187
122491,30,83,127,2,86,3,7,308,216
41755,12,18,44,1,145,4,5,217,24
39039,11,24,80,0,23,0,9,136,10
20870,9,53,98,2,185,10,6,354,294
88040,20,230,129,0,381,5,10,755,145
50251,14,101,451,3,176,17,12,760,53
40563,12,181,12,0,150,1,4,348,22
91626,21,55,157,1,67,4,5,289,159
49124,14,18,195,1,1,1,3,219,50
53973,14,71,18,0,6,1,1,97,44
7330,5,45,18,4,9,1,1,78,246
35797,11,104,184,1,59,8,27,383,16
104705,25,66,178,3,123,13,7,390,182
67910,15,29,52,2,189,4,4,280,81
12085,7,89,42,1,190,15,13,350,260
84212,19,93,101,3,51,10,8,266,118
13371,7,29,12,0,138,2,8,189,263
100338,24,99,167,0,56,2,11,335,173
110008,27,159,6,0,171,0,1,337,194
28952,9,33,133,1,202,15,5,389,286
6274,4,85,132,0,44,0,9,270,243
70105,15,40,9,0,71,0,4,124,86
72512,16,66,164,2,122,10,7,371,102
72156,16,38,59,2,121,1,7,228,101
92993,21,45,94,4,81,10,5,239,163
111149,27,109,14,0,256,0,0,379,197
972,1,67,204,2,61,15,8,357,3
83865,19,98,38,0,47,39,9,231,128
26099,9,44,76,2,282,8,6,418,279
59289,15,19,93,4,183,6,14,319,96
72649,16,133,32,0,73,2,8,248,102
14710,7,63,59,0,160,4,9,295,256
129950,32,66,69,1,61,7,0,204,240
95332,21,70,59,0,75,2,11,217,153
116924,29,42,89,6,128,7,14,286,209
39790,11,54,112,5,90,2,8,271,12
28932,9,37,207,4,143,10,4,405,286
114377,28,114,115,4,63,4,10,310,203
64883,15,94,173,4,124,13,15,423,72
122208,30,32,135,1,58,14,3,243,215
37380,11,60,228,2,68,10,6,374,20
28807,9,30,70,1,219,16,10,346,286
117958,30,54,77,3,76,0,7,217,226
74691,16,30,77,0,57,4,2,170,106
117433,30,113,126,0,82,6,17,344,212
38387,11,51,69,2,50,3,4,179,9
4833,3,46,82,2,99,4,6,239,210
97167,22,37,200,0,72,4,4,317,166
12233,7,124,23,1,51,0,20,219,260
59216,15,170,83,7,114,10,24,408,96
12814,7,69,50,3,114,1,18,255,262
70205,15,60,157,3,168,24,6,418,87
86679,20,93,43,0,108,8,5,257,141
107476,26,36,276,3,67,6,3,391,188
83260,19,105,109,5,49,11,15,294,126
74799,16,105,52,2,91,0,14,264,106
3488,2,60,110,3,39,11,3,226,134
112168,28,44,151,3,47,11,4,260,199
89123,20,54,87,2,186,11,8,348,147
116085,29,38,125,1,87,4,14,269,207
122182,30,37,155,0,67,6,11,276,215
31807,9,41,98,3,278,7,5,432,293
96844,22,53,132,8,104,2,17,316,165
80666,19,87,157,16,66,14,17,357,117
105105,25,36,108,4,40,5,4,197,183
63662,15,54,130,3,158,19,6,370,69
64310,15,88,86,1,172,9,11,367,70
100948,24,34,219,0,88,13,1,355,175
107176,26,52,154,1,38,3,8,256,187
7357,5,103,97,1,12,1,4,218,246
49591,14,175,246,2,29,13,13,478,52
34548,11,36,220,1,46,2,15,320,8
86065,20,82,62,0,226,3,7,380,140
67426,15,40,84,3,193,11,0,331,80
107918,26,107,60,1,242,15,28,453,189
6525,5,80,200,0,45,8,3,336,244
9412,5,160,92,3,46,10,17,328,250
124823,30,123,43,0,39,1,15,221,221
32019,10,39,110,2,69,8,14,242,4
75473,16,49,236,2,97,17,8,409,108
78486,17,65,93,33,52,7,8,258,112
30360,9,28,189,3,252,23,4,499,290
50341,14,40,326,2,53,11,1,433,53
117,1,80,117,11,25,1,1,235,1
72643,16,70,14,0,143,2,8,237,102
5419,3,32,88,2,110,5,7,244,211
16781,8,86,93,6,39,4,10,238,268
7422,5,57,38,0,4,0,9,108,246
110506,27,90,31,1,278,1,16,417,195
18485,8,20,91,5,18,2,3,139,271
3254,2,34,147,6,52,10,1,250,133
128569,32,35,98,1,115,7,9,265,238
24083,9,47,202,0,163,5,2,419,275
43823,12,92,30,3,62,2,4,193,28
112574,28,37,126,2,100,8,11,284,200
86105,20,153,23,1,179,0,15,371,140
129117,32,62,111,8,98,11,6,296,239
10614,7,149,43,0,50,1,16,259,253
126440,31,207,116,0,19,0,8,350,233
111408,27,168,11,1,219,3,4,406,198
17442,8,77,168,4,28,4,3,284,269
21754,9,22,85,3,283,17,8,418,296
65073,15,107,31,2,111,3,18,272,72
10231,7,102,28,3,139,2,7,281,253
123881,30,66,211,1,60,6,15,359,219
71767,16,62,65,3,208,9,2,349,97
116986,29,43,127,5,185,8,12,380,209
61937,15,85,111,7,170,8,7,388,63
10972,7,120,1,0,153,0,10,284,257
79199,18,126,11,4,184,3,17,345,114
118167,30,66,47,1,18,1,6,139,226
96243,22,75,137,0,8,2,8,230,164
123374,30,41,103,0,115,8,5,272,218
30900,9,38,55,5,233,13,3,347,291
10916,7,149,26,1,111,1,19,307,257
89164,20,143,67,1,40,1,23,275,147
6425,5,54,104,2,44,7,1,212,244
91602,21,63,97,1,63,10,1,235,159
108483,26,82,120,7,60,5,8,282,190
2383,2,47,68,4,57,4,14,194,131
101337,24,39,143,1,61,17,10,271,176
70860,15,106,25,1,106,3,5,246,88
52242,14,73,156,7,70,15,9,330,40
101966,24,111,278,0,110,6,29,534,177
26224,9,23,141,0,88,11,3,266,280
54610,14,137,57,5,114,19,8,340,46
38248,11,65,145,4,39,5,13,271,9
103952,25,68,92,7,130,10,8,315,181
75099,16,35,162,1,136,16,18,368,107
21357,9,31,106,2,298,22,9,468,295
55547,14,58,184,4,90,11,14,361,48
76899,16,102,220,2,48,11,9,392,100
90928,21,172,244,0,24,2,16,458,157
122030,30,74,226,1,116,15,7,439,215
96848,22,67,191,7,43,4,8,320,165
18995,8,97,203,14,49,7,13,383,272
31987,9,41,86,1,171,16,5,320,293
61997,15,80,72,7,138,12,12,321,64
60958,15,41,78,7,179,12,7,324,61
120074,30,75,79,0,150,3,2,309,231
124745,30,113,139,1,78,6,16,353,221
88196,20,141,29,0,179,4,1,354,145
7789,5,46,102,4,27,3,5,187,246
59880,15,56,63,7,194,16,6,342,58
60525,15,44,53,6,185,11,8,307,60
72869,16,137,55,1,156,11,15,375,102
1672,2,70,133,6,58,7,5,279,130
11067,7,52,52,1,80,1,5,191,258
27594,9,26,352,0,89,9,4,480,282
7948,5,131,209,1,82,10,10,443,247
71840,16,50,37,1,176,3,5,272,97
95189,21,78,48,4,136,8,10,284,153
64640,15,78,167,4,128,25,8,410,71
31483,9,31,122,0,167,19,2,341,292
88167,20,121,59,0,56,4,19,259,145
8382,5,62,125,0,48,7,4,246,248
69611,15,55,85,6,105,15,4,270,85
114097,28,113,152,5,125,12,1,408,203
66003,15,108,209,5,71,12,5,410,75
125030,30,108,117,1,154,2,13,395,222
124213,30,49,143,0,100,4,7,303,220
130052,32,23,8,1,58,0,4,94,240
91622,21,59,159,2,105,7,13,345,159
43400,12,146,17,0,217,2,13,395,27
79087,18,41,10,0,26,2,1,80,114
9397,5,82,132,3,49,9,8,283,250
21569,9,19,163,1,92,10,5,290,296
112219,28,76,121,1,68,4,10,280,199
109961,27,120,19,1,227,1,6,374,194
112335,28,88,156,3,107,14,7,375,199
56798,15,107,66,7,105,8,6,299,79
96127,22,130,125,1,65,11,1,333,164
32136,10,39,34,0,68,0,7,148,4
105779,25,70,60,1,47,1,9,188,184
80597,19,29,373,0,31,7,3,443,117
108049,26,47,71,6,101,9,3,237,189
31595,9,18,117,1,213,22,5,376,292
93347,21,59,163,1,104,11,7,345,163
89474,20,100,63,2,166,2,17,350,138
20886,9,16,96,1,287,22,6,428,294
4116,2,47,91,7,74,7,228,454,135
75741,16,25,139,0,85,10,6,265,98
62881,15,17,373,0,39,3,5,437,66
124015,30,55,166,1,178,13,11,424,219
68953,15,72,174,5,81,17,10,359,84
27937,9,21,68,1,213,15,5,323,283
47899,14,7,150,2,50,4,14,227,38
69475,15,112,114,3,143,18,10,400,85
66020,15,81,182,5,118,24,11,421,75
3023,2,52,125,1,29,10,7,224,133
47429,13,64,96,1,104,18,6,289,36
4637,2,80,138,3,82,11,12,326,136
62457,15,40,40,1,147,10,3,241,65
100114,24,98,134,0,4,5,27,268,173
39992,11,60,34,4,69,1,8,176,13
70534,15,76,52,6,184,14,10,342,88
59313,15,141,48,2,132,6,21,350,96
114656,28,95,99,4,122,11,6,337,204
107086,26,58,184,4,48,9,3,306,187
87465,20,77,1,0,69,0,5,152,143
82609,19,55,325,9,84,18,1,492,125
83954,19,113,137,4,19,5,4,282,128
90936,21,78,77,2,75,5,9,246,157
49983,14,64,65,1,6,1,2,139,52
85160,19,101,154,50,37,7,15,364,120
19070,8,83,123,5,36,6,7,260,272
10746,7,37,22,0,25,0,5,89,257
62806,15,53,139,1,171,15,3,382,65
130783,32,32,9,0,43,1,2,87,241
59343,15,103,28,2,64,1,20,218,96
64430,15,56,157,2,113,17,8,353,71
33249,10,41,92,3,111,8,5,260,6
43038,12,68,5,0,88,0,1,162,27
38076,11,77,141,1,36,11,9,275,21
116706,29,21,43,5,49,2,13,133,209
90546,21,87,165,4,116,18,15,405,156
14941,7,117,77,0,175,5,26,400,256
94570,21,60,135,7,103,7,11,323,151
92407,21,67,70,4,104,3,14,262,161
3962,2,33,120,8,81,6,12,260,135
121731,30,97,25,0,214,3,12,351,214
38261,11,39,164,9,116,18,8,354,9
8682,5,109,100,0,104,5,16,334,249
76061,16,4,74,0,53,0,1,132,98
78974,17,33,111,2,158,10,9,323,113
53709,14,80,148,5,145,16,15,409,43
3472,2,42,61,0,36,3,0,142,134
115470,28,97,151,1,79,4,17,349,206
2859,2,60,71,3,94,4,1,233,132
103607,25,45,65,0,28,3,5,146,180
88965,20,7,11,0,123,1,6,148,147
11578,7,61,31,0,85,1,4,182,259
127294,31,95,152,3,92,10,15,367,235
67928,15,25,59,4,185,11,5,289,81
121496,30,94,86,1,237,7,13,438,214
54182,14,79,119,1,56,0,5,260,44
48934,14,23,58,2,11,2,0,96,50
95501,21,60,180,7,160,20,7,434,154
63807,15,43,120,3,256,24,2,448,69
3820,2,61,45,3,34,5,4,152,134
5290,3,23,176,2,138,12,5,356,211
81727,19,47,299,4,56,11,5,422,123
29465,9,31,62,3,285,15,6,402,288
100645,24,71,105,4,125,1,12,318,174
56699,15,50,133,3,97,14,13,310,68
103512,25,53,64,0,56,3,8,184,180
23571,9,41,66,3,193,7,0,310,300
31267,9,33,107,1,289,11,11,452,292
94734,21,105,24,1,61,3,14,208,152
81008,19,99,124,8,41,6,2,280,121
65177,15,68,88,1,168,16,14,355,73
29386,9,22,55,2,313,10,16,418,288
88913,20,83,145,1,75,1,20,325,147
112939,28,41,84,0,26,3,9,163,201
118016,30,90,67,6,180,2,9,354,226
79129,18,54,6,1,31,2,3,97,114
86181,20,85,33,1,152,1,21,293,140
26259,9,41,158,1,123,19,4,346,280
5642,4,90,99,2,107,14,18,330,242
125390,30,81,151,2,115,9,11,369,222
8125,5,135,114,2,61,15,12,339,247
10901,7,187,72,3,146,4,7,419,257
48450,14,70,191,1,40,12,7,321,49
68379,15,59,51,4,215,18,17,364,82
64076,15,37,343,1,79,12,8,480,70
130016,32,83,120,4,106,8,24,345,240
104560,25,51,77,6,108,18,6,266,182
87457,20,123,13,0,199,0,1,336,143
114602,28,89,52,2,38,0,5,186,204
41539,12,45,35,0,146,1,10,237,24
127008,31,141,107,1,80,0,10,339,234
99483,24,112,103,3,78,5,13,314,171
67303,15,33,87,6,194,15,6,341,78
48718,14,138,189,1,19,2,13,362,49
98648,23,76,58,1,126,3,7,271,170
91335,21,67,27,2,62,2,12,172,158
39714,11,31,156,2,11,1,7,208,12
91014,21,96,175,1,122,14,8,416,157
14192,7,104,58,0,96,3,14,275,254
95933,21,82,98,2,121,2,10,315,155
130341,32,72,225,3,161,34,7,502,241
126098,30,181,41,1,163,1,0,387,225
116639,29,49,92,1,168,13,9,332,209
38506,11,91,261,4,76,17,10,459,9
64577,15,25,291,0,56,14,6,392,71
4741,2,74,112,4,70,7,11,278,136
23642,9,27,103,2,192,12,9,345,300
15938,8,86,91,9,54,8,2,250,266
19941,9,18,56,3,288,14,5,384,274
99891,24,68,121,3,43,3,34,272,172
96096,22,61,177,3,86,3,29,359,164
125336,30,139,144,1,108,4,25,421,222
34104,10,86,157,3,59,8,18,331,7
53511,14,65,158,5,73,14,10,325,43
72214,16,61,75,3,43,2,9,193,101
43092,12,53,41,5,132,6,13,250,27
110066,27,74,0,0,26,0,4,104,194
95021,21,108,68,4,73,3,6,262,153
21564,9,41,72,3,273,18,13,420,296
29135,9,28,136,4,263,31,10,472,287
51782,14,61,295,1,71,19,6,453,39
75774,16,40,266,0,119,20,11,456,98
49438,14,120,175,5,69,19,19,407,51
76567,16,6,2,0,143,0,5,156,100
72594,16,65,10,2,118,0,3,198,102
80002,18,16,21,1,28,0,2,68,116
39516,11,48,296,4,56,12,16,432,12
68061,15,48,56,2,153,18,3,280,81
36556,11,77,236,2,33,10,13,371,18
18278,8,55,41,0,42,4,0,142,271
19574,8,75,156,6,47,13,5,302,273
110193,27,82,10,2,199,1,1,295,195
6950,5,44,78,3,73,2,2,202,245
20483,9,18,133,1,123,17,4,296,285
118949,30,60,120,1,148,10,6,345,228
67085,15,61,50,1,190,15,3,320,78
120894,30,121,125,2,154,12,18,432,232
96482,22,62,170,1,103,6,15,357,164
97667,22,49,134,4,77,8,2,274,167
59837,15,35,57,4,199,9,4,308,58
43440,12,75,21,4,95,2,8,205,27
108381,26,41,274,4,69,10,2,400,190
9834,6,80,193,1,136,15,4,429,251
42870,12,60,8,23,87,5,8,191,26
11618,7,65,22,0,73,1,12,173,259
81767,19,42,352,6,46,12,8,466,123
47955,14,97,195,3,78,9,18,400,38
99159,24,73,255,3,100,20,7,458,171
2895,2,70,149,13,103,8,4,347,132
124180,30,236,69,3,87,1,14,410,220
20327,9,24,110,0,96,14,1,245,285
95786,21,57,115,0,99,0,6,277,155
28751,9,36,113,4,167,8,5,333,286
31774,9,33,59,0,263,11,2,368,293
19741,8,67,88,4,23,0,5,187,273
111843,28,78,28,2,54,0,3,165,199
94056,21,46,167,3,134,15,10,375,150
18301,8,100,68,5,65,10,7,255,271
45581,13,69,72,10,218,8,3,380,32
61285,15,79,136,6,165,23,16,425,62
17720,8,90,248,5,54,7,4,408,270
15250,8,119,129,12,58,12,3,333,265
61821,15,28,266,0,75,11,1,381,63
116326,29,48,135,2,129,9,14,337,208
61691,15,42,238,1,96,11,8,396,63
65496,15,72,75,5,205,16,9,382,73
103632,25,61,51,2,48,0,4,166,180
37630,11,74,227,11,62,17,14,405,20
87231,20,120,39,0,142,5,21,327,143
8563,5,60,162,1,88,8,5,324,248
121489,30,72,66,1,175,4,12,330,214
39966,11,30,137,3,135,19,15,339,13
20648,9,21,70,1,201,15,4,312,294
64530,15,64,22,2,51,1,6,146,71
170,1,121,223,7,29,6,10,396,1
2886,2,61,138,6,85,8,13,311,132
12773,7,7,9,0,54,0,0,70,262
113789,28,84,111,0,73,10,8,286,202
69223,15,62,210,1,93,9,14,389,84
44388,12,33,63,2,194,3,11,306,29
102766,25,89,108,0,72,4,12,285,178
54997,14,140,213,3,61,12,7,436,46
102371,25,41,25,1,9,1,3,80,178
58141,15,37,94,3,104,13,6,257,93
90439,21,83,131,1,80,6,14,315,156
5668,4,79,138,2,159,18,17,413,242
81331,19,92,258,6,83,18,11,468,122
27182,9,28,68,3,209,15,4,327,281
91281,21,75,158,3,81,9,9,335,158
22707,9,60,98,4,322,15,8,507,298
85437,19,58,127,3,123,6,9,326,120
16574,8,78,41,4,29,5,6,163,268
26351,9,39,266,1,114,11,3,434,280
61145,15,64,53,18,195,11,8,349,61
110719,27,127,20,2,181,2,1,333,196
38923,11,105,158,0,62,2,21,348,10
12157,7,42,8,5,144,1,16,216,260
122099,30,57,130,1,65,8,14,275,215
96825,22,56,188,5,144,15,11,419,165
102890,25,83,115,2,96,14,8,318,179
19489,8,105,172,3,33,10,7,330,273
8547,5,49,206,3,95,11,7,371,248
9414,5,145,71,2,34,7,18,277,250
80241,18,68,72,0,76,10,3,229,116
77521,17,35,105,7,187,18,8,360,110
93493,21,14,139,7,158,4,8,330,149
65877,15,80,287,5,99,35,21,527,75
4951,3,4,1,0,46,0,3,54,210
69854,15,165,75,3,104,1,4,352,86
98004,23,151,44,1,181,3,11,391,168
65066,15,70,92,0,84,1,25,272,72
68520,15,52,102,6,146,13,6,325,83
27661,9,27,50,2,312,4,14,409,282
122634,30,56,142,1,91,4,5,299,216
48324,14,122,168,2,79,9,19,399,38
13744,7,51,82,4,199,4,11,351,264
43741,12,69,64,3,195,15,10,356,28
10160,6,148,121,0,55,2,2,328,252
57820,15,38,89,3,173,15,7,325,92
107011,26,61,149,4,83,5,5,307,187
39569,11,77,113,2,11,4,10,217,12
10130,6,105,111,0,59,3,0,278,252
114404,28,136,156,6,97,2,6,403,204
7232,5,67,47,3,142,4,4,267,245
52139,14,103,217,10,66,22,7,425,40
17352,8,88,126,1,29,4,4,252,269
62827,15,109,111,5,176,13,3,417,66
20362,9,41,174,2,165,19,5,406,285
23725,9,26,102,2,218,12,15,375,300
39953,11,30,113,4,94,11,11,263,13
114484,28,92,130,3,56,4,6,291,204
94785,21,70,66,0,24,0,9,169,152
3582,2,65,110,5,82,11,0,273,134
34873,11,58,157,3,61,134,62,475,14
121378,30,76,161,1,175,11,4,428,214
101335,24,44,206,5,64,12,5,336,176
37706,11,55,160,3,29,12,6,265,20
75193,16,40,161,0,149,12,8,370,107
64006,15,72,76,4,203,23,11,389,69
106222,25,56,138,1,153,14,4,366,185
53089,14,81,152,2,74,5,10,324,42
116859,29,34,110,2,56,5,3,210,209
126693,31,171,195,3,54,4,14,441,234
8645,5,81,41,2,91,4,4,223,248
44083,12,35,7,0,27,0,4,73,29
104950,25,103,46,0,4,0,1,154,183
75084,16,26,139,2,113,11,11,302,107
39063,11,28,105,0,70,1,7,211,10
7594,5,31,146,0,34,6,2,219,246
3501,2,46,147,3,56,9,2,263,134
88837,20,73,100,3,255,12,16,459,146
72331,16,31,98,1,94,3,4,231,101
120367,30,83,142,4,113,13,7,362,231
118190,30,72,74,1,91,8,7,253,226
100931,24,56,215,0,82,18,12,383,175
81590,19,86,264,5,44,9,14,422,122
126256,31,269,259,0,15,0,6,549,233
28630,9,52,95,1,286,13,8,455,286
70745,15,52,106,3,155,13,16,345,88
60549,15,53,76,5,216,14,14,378,60
27730,9,46,179,3,196,13,13,450,283
72158,16,26,35,0,148,6,9,224,101
35342,11,73,274,0,67,11,22,447,15
7719,5,56,230,0,55,11,11,363,246
47759,13,78,99,5,141,17,9,349,37
21295,9,56,85,8,340,31,11,531,295
121691,30,33,81,0,116,13,7,250,214
61272,15,25,355,1,55,8,4,448,62
113803,28,80,135,2,81,4,11,313,202
43162,12,17,19,0,134,3,8,181,27
66086,15,131,149,6,57,8,21,372,75
85248,19,161,300,5,48,5,13,532,120
119620,30,75,146,2,75,7,5,310,230
34893,11,36,160,3,79,10,9,297,14
34766,11,20,69,0,14,1,6,110,14
80864,19,61,174,6,58,9,15,323,117
121595,30,51,53,1,169,8,7,289,214
6444,5,50,120,2,86,9,9,276,244
18698,8,157,96,3,40,11,18,325,272
58351,15,54,118,2,165,16,1,356,94
123060,30,32,41,0,131,4,6,214,217
80929,19,102,159,8,64,13,14,360,121
56397,15,49,202,2,174,13,9,449,68
121470,30,57,138,0,224,8,6,433,214
70796,15,57,97,3,170,15,7,349,88
49695,14,34,155,3,24,5,14,235,52
50277,14,66,380,2,57,10,0,515,53
60601,15,97,23,2,94,8,11,235,60
83687,19,103,148,4,52,7,21,335,127
44259,12,111,16,0,169,1,7,304,29
45944,13,121,48,2,148,3,10,332,33
54552,14,3,30,3,11,2,2,51,45
2927,2,58,122,4,43,10,4,241,133
122680,30,148,232,3,52,4,9,448,216
42251,12,49,93,0,130,15,8,295,25
71408,15,57,101,8,67,7,22,262,91
124319,30,82,74,5,77,2,10,250,220
7158,5,58,83,1,29,1,0,172,245
109720,27,278,2,0,109,1,9,399,193
75453,16,38,95,2,92,15,18,260,108
37650,11,68,186,14,79,5,26,378,20
3500,2,41,161,4,57,11,3,277,134
60292,15,72,57,9,205,13,10,366,59
51920,14,40,299,0,55,21,4,419,39
52501,14,161,142,7,74,10,1,395,41
118988,30,78,94,2,103,13,13,303,228
36642,11,69,305,5,38,9,12,438,18
111641,27,125,8,1,164,3,11,312,198
57575,15,81,121,4,190,24,7,427,92
110166,27,128,13,0,124,1,6,272,194
80896,19,129,175,1,70,8,10,393,121
74357,16,42,18,0,235,1,4,300,106
80291,18,49,47,2,85,0,3,186,116
67622,15,38,87,1,191,16,8,341,80
48038,14,119,176,7,105,12,15,434,38
97411,22,83,156,1,96,8,10,354,167
9135,5,97,129,2,68,18,6,320,250
46427,13,49,17,8,44,0,2,120,34
48515,14,96,188,3,18,6,9,320,49
61566,15,47,280,2,111,9,7,456,63
99819,24,90,137,0,41,3,13,284,172
37947,11,62,177,3,29,14,14,299,21
77223,17,70,158,5,216,18,13,480,109
114702,28,82,136,5,118,2,8,351,204
76062,16,12,38,1,56,1,5,113,98
67255,15,53,85,1,165,14,6,324,78
119588,30,68,150,2,47,0,4,271,230
44178,12,111,21,2,68,2,5,209,29
111128,27,177,24,2,345,1,0,549,197
108504,26,69,124,2,44,5,18,262,190
8049,5,122,73,3,43,14,16,271,247
100386,24,74,147,1,23,0,12,257,173
117241,30,46,81,1,73,3,8,212,212
42699,12,3,1,0,179,0,3,186,26
37297,11,71,237,1,85,15,7,416,20
60047,15,56,105,1,220,15,12,409,59
83965,19,177,83,2,146,7,31,446,128
48679,14,65,164,0,52,7,12,300,49
77614,17,32,163,6,189,11,5,406,110
44670,12,46,33,3,174,17,12,285,30
82421,19,120,85,3,104,13,18,343,124
103812,25,120,82,0,107,4,10,323,180
130311,32,44,278,1,86,4,2,415,241
40337,11,67,140,5,22,4,3,241,13
115469,28,84,161,1,75,7,9,337,206
33643,10,114,142,0,31,3,13,303,6
50974,14,50,220,2,62,9,4,347,55
68213,15,75,58,2,221,16,6,378,82
79471,18,72,28,1,139,1,2,243,114
54738,14,58,249,9,59,13,7,395,46
58565,15,32,349,2,147,25,3,558,94
84832,19,134,81,5,48,14,18,300,119
11789,7,80,13,1,271,1,8,374,259
11017,7,85,52,0,76,1,8,222,257
65138,15,144,21,2,153,2,11,333,72
5201,3,70,102,0,181,13,12,378,211
46417,13,35,25,2,37,2,4,105,34
12608,7,65,12,2,81,1,13,174,261
79345,18,63,2,0,101,3,0,169,114
48594,14,60,62,2,83,4,19,230,49
65147,15,67,80,1,111,5,20,284,72
80109,18,66,55,1,98,0,7,227,116
50793,14,111,280,6,95,12,16,520,55
28696,9,37,95,2,222,9,10,375,286
103070,25,82,124,1,102,10,7,326,179
32086,10,94,140,6,59,2,16,317,4
125096,30,75,82,2,163,7,15,344,222
55317,14,106,94,0,18,2,6,226,47
74502,16,75,57,2,148,5,5,292,106
52024,14,90,182,7,63,19,14,375,39
79030,17,98,67,3,104,6,25,303,113
130552,32,52,103,5,58,11,11,240,241
27807,9,36,89,3,298,14,8,448,283
9867,6,41,85,2,53,1,18,200,251
127733,31,112,197,0,77,8,14,408,236
73393,16,63,80,1,36,1,4,185,103
106819,26,61,125,3,93,10,13,305,186
35715,11,45,140,0,15,2,3,205,16
30226,9,53,175,0,201,17,10,456,290
86619,20,92,13,1,41,3,10,160,141
30562,9,51,106,7,281,22,10,477,290
99054,24,79,175,3,106,16,15,394,171
126848,31,137,251,3,87,9,25,512,234
9567,6,67,157,0,85,12,4,325,251
73465,16,45,213,1,60,6,2,327,104
40252,11,44,140,0,87,5,2,278,13
58969,15,80,67,3,177,11,13,351,95
4698,2,45,203,6,115,13,8,390,136
82673,19,75,169,3,57,19,7,330,125
113608,28,46,106,1,52,9,11,225,202
116037,29,57,155,1,134,6,43,396,207
69446,15,51,134,5,186,13,15,404,85
29216,9,28,54,2,279,14,7,384,287
58028,15,60,125,2,177,26,4,394,93
126841,31,161,206,4,25,3,10,409,234
85857,20,215,36,2,228,2,9,492,137
87114,20,124,90,0,164,12,7,397,142
71435,15,66,190,3,113,28,11,411,91
26878,9,41,110,3,268,27,16,465,281
55558,14,87,175,3,97,9,19,390,48
79634,18,113,98,7,222,20,6,466,115
127176,31,65,261,2,60,12,7,407,235
51359,14,76,166,4,75,15,7,343,56
75482,16,19,139,3,109,13,8,291,108
7004,5,74,84,4,37,8,7,214,245
57833,15,73,63,4,138,12,10,300,92
93043,21,45,123,1,130,10,10,319,163
70308,15,78,119,2,144,17,8,368,87
1602,2,41,78,4,31,18,4,176,129
28991,9,23,110,2,201,12,13,361,286
109456,27,149,23,3,111,0,6,292,193
1217,1,145,130,2,43,5,18,343,3
82163,19,145,87,7,36,7,34,316,124
74934,16,32,164,1,137,10,8,352,107
103477,25,64,73,0,17,1,2,157,180
16659,8,119,113,7,61,4,17,321,268
83474,19,129,132,2,37,7,15,322,127
11294,7,72,0,2,24,0,4,102,258
22551,9,25,104,5,284,9,3,430,298
63107,15,53,71,0,47,1,1,173,66
78038,17,48,103,7,174,21,11,364,111
28774,9,37,123,4,318,17,10,509,286
58239,15,50,82,4,187,16,13,352,93
40276,11,96,26,2,37,5,29,195,13
12275,7,61,74,4,88,0,13,240,261
129617,32,58,47,1,50,0,3,159,239
110387,27,119,7,0,277,0,5,408,195
20587,9,32,117,4,266,28,8,455,285
27028,9,18,62,0,217,17,12,326,281
28809,9,29,111,1,150,11,6,308,286
81863,19,35,293,2,44,14,2,390,123
79158,18,54,39,0,36,0,8,137,114
53415,14,57,270,3,68,17,7,422,43
56420,15,87,72,5,180,17,11,372,68
67053,15,54,78,4,206,6,8,356,78
39774,11,52,187,2,87,12,9,349,12
125950,30,129,76,3,188,7,11,414,225
6999,5,86,71,7,60,9,9,242,245
119291,30,40,87,2,164,2,10,305,229
98480,23,113,133,5,138,19,13,421,169
77510,17,77,142,5,120,2,8,354,110
75842,16,27,135,3,142,6,12,325,98
128879,32,142,34,2,63,3,7,251,238
125598,30,158,152,2,68,5,4,389,224
113851,28,72,137,1,95,16,14,335,202
82901,19,39,139,3,47,12,9,249,126
76816,16,64,57,2,146,11,11,291,100
120795,30,89,130,2,140,2,33,396,232
66882,15,119,58,9,245,5,8,444,77
67933,15,76,84,2,251,18,11,442,81
3522,2,80,155,4,76,20,1,336,134
129456,32,11,71,1,40,1,8,132,239
107491,26,62,209,4,70,18,8,371,188
4940,3,1,7,0,29,0,0,37,210
83448,19,102,213,4,67,12,12,410,127
38102,11,46,159,3,13,5,17,243,21
12181,7,153,7,0,21,0,7,188,260
50000,14,79,77,14,77,31,14,292,52
1720,2,55,103,0,43,7,11,219,130
54586,14,115,199,8,65,14,12,413,45
58525,15,47,259,4,204,21,10,545,94
49478,14,118,174,7,81,26,9,415,51
89466,20,106,38,3,221,4,10,382,138
26518,9,24,213,2,166,16,7,428,280
71775,16,45,10,0,36,1,3,95,97
94266,21,50,112,3,84,16,8,273,151
42021,12,93,7,1,207,3,4,315,24
24714,9,28,47,4,168,12,1,260,276
66767,15,55,126,4,174,17,5,381,77
85298,19,95,123,3,60,7,13,301,120
92186,21,161,104,2,89,2,7,365,160
71860,16,49,42,2,201,4,10,308,97
1229,1,110,102,2,11,8,5,238,3
70345,15,62,166,5,209,21,9,472,87
106444,26,145,249,4,60,4,9,471,186
99015,24,56,66,1,7,3,1,134,171
113382,28,108,148,0,75,3,6,340,201
33449,10,206,111,1,17,0,13,348,6
59298,15,54,105,4,159,10,16,348,96
130477,32,45,109,8,133,12,11,318,241
39631,11,39,131,12,61,4,30,277,12
21377,9,40,87,4,336,22,10,499,295
122999,30,105,104,3,232,11,5,460,217
82509,19,26,233,2,19,1,1,282,125
27215,9,37,95,5,245,13,5,400,281
43730,12,75,80,1,172,8,8,344,28
11380,7,4,1,0,32,0,2,39,258
73537,16,59,150,0,40,6,8,263,104
83416,19,96,152,7,71,5,10,341,127
36371,11,30,255,2,48,18,3,356,18
105428,25,53,338,0,93,13,2,499,184
32045,10,91,159,1,48,9,9,317,4
121665,30,88,58,0,214,4,15,379,214
8769,5,66,242,0,83,11,4,406,249
89086,20,55,78,3,118,1,18,273,147
27364,9,45,79,4,245,19,14,406,282
4028,2,49,91,3,46,10,5,204,135
657,1,71,96,1,60,10,6,244,2
80795,19,83,185,16,59,15,16,374,117
72890,16,111,61,0,113,4,9,298,102
66488,15,73,109,3,111,7,15,318,76
76944,16,27,24,0,114,2,7,174,100
92839,21,35,81,2,195,16,8,337,162
72075,16,15,55,2,83,7,3,165,101
5564,4,78,152,4,136,9,3,382,242
43857,12,111,26,4,87,0,6,234,28
86605,20,40,10,1,157,4,16,228,141
82829,19,79,116,8,61,11,8,283,126
126035,30,59,108,6,118,2,5,298,225
28126,9,59,65,5,312,19,11,471,283
68322,15,64,49,1,229,17,7,367,82
121260,30,77,141,2,175,29,11,435,213
127055,31,152,165,2,46,1,13,379,234
1995,2,60,201,1,75,15,4,356,130
73511,16,62,214,1,65,14,6,362,104
80797,19,85,193,17,69,13,9,386,117
113927,28,79,159,1,97,8,8,352,202
101782,24,95,146,0,95,6,22,364,177
10116,6,161,116,2,100,5,7,391,252
114263,28,73,138,3,93,11,3,321,203
126504,31,2,73,0,3,0,2,80,233
18886,8,145,126,2,62,12,16,363,272
42418,12,36,70,1,205,11,13,336,25
99641,24,45,197,4,78,14,14,352,172
15187,8,94,47,7,34,9,4,195,265
42979,12,12,2,0,70,5,0,89,26
28909,9,29,115,1,239,22,9,415,286
83242,19,44,175,2,33,7,3,264,126
86972,20,45,13,0,35,5,7,105,142
41352,12,64,70,1,108,3,11,257,23
118598,30,37,137,2,56,3,9,244,227
57439,15,62,163,9,187,18,15,454,90
39981,11,46,154,3,143,8,13,367,13
55900,14,176,47,2,49,7,3,284,48
772,1,222,77,0,32,4,0,335,2
24633,9,45,200,2,214,19,8,488,276
41500,12,35,37,5,71,5,5,158,23
59083,15,81,93,1,200,21,18,414,95
60838,15,35,76,4,198,13,14,340,61
21074,9,23,54,4,233,9,2,325,294
60975,15,36,117,2,277,22,10,464,61
33705,10,54,31,5,99,0,7,196,6
35798,11,77,156,8,81,5,30,357,16
1835,2,49,209,7,53,11,8,337,130
43930,12,39,24,11,131,5,7,217,28
79353,18,81,40,1,164,9,7,302,114
67744,15,56,58,0,164,18,5,301,80
107409,26,71,256,3,57,16,2,405,188
57513,15,68,91,6,153,19,10,347,90
64926,15,81,37,0,128,2,13,261,72
118542,30,70,142,1,80,11,14,318,227
12042,7,89,44,1,209,14,5,362,260
102417,25,73,31,1,24,1,1,131,178
66926,15,78,77,6,185,7,7,360,77
112011,28,41,116,3,38,4,2,204,199
31352,9,20,51,3,344,12,14,444,292
28340,9,22,63,1,247,15,9,357,284
89919,20,132,6,0,154,0,3,295,139
7961,5,164,61,2,72,10,12,321,247
70798,15,68,81,3,173,15,16,356,88
75618,16,24,54,1,20,2,8,109,108
59081,15,53,81,3,225,16,17,395,95
22788,9,123,107,3,193,16,0,442,298
60783,15,46,108,2,252,19,16,443,61
77401,17,48,181,0,160,16,10,415,109
35335,11,38,178,2,16,3,6,243,15
110440,27,150,5,0,185,1,2,343,195
74097,16,42,65,0,121,5,9,242,105
32566,10,58,85,1,107,2,10,263,5
2827,2,28,67,3,43,3,3,147,132
69998,15,110,147,4,138,9,14,422,86
8526,5,96,126,0,98,9,8,337,248
19534,8,66,243,1,35,9,11,365,273
107680,26,26,24,0,3,0,3,56,189
25732,9,13,75,1,239,17,14,359,278
53891,14,61,152,5,106,6,11,341,44
73233,16,35,155,2,81,6,7,286,103
20007,9,31,113,6,273,16,4,443,274
80200,18,46,29,0,18,2,0,95,116
101430,24,46,232,0,79,30,8,395,176
100661,24,59,85,3,118,4,13,282,174
123274,30,54,23,1,25,1,13,117,218
45798,13,76,57,3,104,8,11,259,33
1024,1,68,108,5,34,5,4,224,3
107030,26,56,139,1,99,4,4,303,187
42283,12,29,17,0,112,1,10,169,25
11389,7,102,29,2,111,4,16,264,258
6595,5,8,15,0,2,1,0,26,244
119157,30,49,186,2,101,5,12,355,228
92185,21,96,126,3,118,8,21,372,160
110356,27,123,20,0,290,0,9,442,195
7029,5,99,122,8,93,10,8,340,245
38637,11,46,101,4,12,6,14,183,9
57894,15,53,77,3,187,8,10,338,92
40122,11,38,100,2,31,3,12,186,13
79867,18,81,45,6,135,5,5,277,115
95192,21,139,193,6,312,19,10,679,153
80966,19,113,198,12,66,20,12,421,121
109782,27,224,11,0,211,0,10,456,193
121194,30,76,126,6,149,24,3,384,213
39923,11,71,174,3,147,11,10,416,13
130029,32,32,191,2,89,7,3,324,240
62977,15,56,148,2,161,14,11,392,66
55991,14,74,33,6,39,5,6,163,48
71787,16,54,2,0,55,1,0,112,97
122442,30,66,139,0,21,2,19,247,216
4618,2,41,101,4,116,12,7,281,136
102714,25,78,129,0,9,0,6,222,178
10819,7,156,32,1,158,3,3,353,257
104247,25,38,75,2,46,2,10,173,181
65167,15,44,92,4,164,20,8,332,73
54262,14,94,231,2,82,17,5,431,45
41262,12,76,145,3,125,11,9,369,23
95363,21,73,9,2,54,1,3,142,153
2822,2,45,63,1,91,1,3,204,132
130656,32,178,19,2,169,8,15,391,241
124018,30,78,148,1,156,5,13,401,219
24984,9,53,77,4,296,9,6,445,277
74904,16,55,245,2,124,24,11,461,107
120245,30,61,180,1,124,19,4,389,231
100847,24,55,157,2,78,23,10,325,175
55454,14,86,185,3,41,5,7,327,47
26538,9,64,178,2,261,18,3,526,280
7099,5,66,104,0,91,4,0,265,245
12291,7,103,53,1,134,2,13,306,261
22428,9,21,95,4,243,9,8,380,298
122770,30,93,50,1,77,4,13,238,217
35325,11,84,315,3,38,11,13,464,15
79442,18,69,19,1,109,1,5,204,114
36103,11,75,302,2,32,8,12,431,17
41949,12,16,9,0,35,0,4,64,24
28193,9,31,94,5,248,8,2,388,284
10436,7,154,1,0,30,0,12,197,253
5190,3,84,79,3,143,6,8,323,211
70674,15,53,107,11,211,20,10,412,88
44510,12,29,48,4,136,7,12,236,30
104608,25,87,132,4,178,12,11,424,182
99014,24,137,213,6,42,13,19,430,171
47793,13,57,108,3,193,21,11,393,37
65327,15,23,228,0,16,3,0,270,73
12091,7,102,56,2,164,10,15,349,260
96474,22,31,260,4,84,4,9,392,164
122433,30,78,119,16,72,7,18,310,216
55099,14,91,168,4,102,16,12,393,47
26670,9,24,194,0,243,19,9,489,280
110184,27,2,1,0,6,0,0,9,195
16518,8,59,120,11,76,14,4,284,268
49889,14,92,133,1,61,6,12,305,52
50786,14,85,189,6,85,19,1,385,55
7970,5,177,53,4,70,4,18,326,247
109582,27,164,14,1,248,1,15,443,193
117001,29,50,111,5,244,15,5,430,209
14475,7,112,22,0,107,4,4,249,255
66971,15,50,53,2,149,15,3,272,78
69136,15,79,172,3,109,10,12,385,84
21533,9,26,65,1,172,11,5,280,295
26244,9,54,199,1,179,16,0,449,280
16133,8,54,191,2,67,6,2,322,267
76286,16,128,63,4,110,11,12,328,99
29462,9,27,43,1,330,13,14,428,288
73221,16,44,181,0,43,1,4,273,103
15210,8,91,56,1,38,6,6,198,265
96508,22,71,129,3,118,6,14,341,164
88917,20,143,78,0,43,2,10,276,147
2837,2,66,88,2,43,6,5,210,132
12218,7,128,49,0,67,7,12,263,260
40154,11,33,125,0,42,7,21,228,13
44608,12,51,41,3,162,10,7,274,30
59148,15,174,51,2,137,4,15,383,96
54683,14,91,83,9,79,4,24,290,46
100173,24,86,185,1,81,11,17,381,173
129510,32,63,142,1,84,9,10,309,239
111144,27,235,4,1,250,0,11,501,197
74871,16,29,193,3,167,11,6,409,107
19732,8,71,29,2,9,1,6,118,273
14020,7,77,37,0,206,1,13,334,254
59423,15,106,60,1,85,4,10,266,96
103120,25,123,105,3,54,5,0,290,179
22078,9,34,97,3,251,21,8,414,297
11921,7,133,8,3,34,1,19,198,260
17085,8,61,155,1,52,8,8,285,269
33480,10,17,56,1,13,1,2,90,6
122402,30,36,147,7,19,2,3,214,216
17848,8,66,189,7,53,7,7,329,270
94991,21,67,49,7,205,4,16,348,153
101229,24,15,103,2,9,2,11,142,175
128801,32,92,155,3,86,4,14,354,238
51609,14,62,178,0,77,11,5,333,56
23866,9,43,68,0,235,11,8,365,300
78608,17,63,152,4,140,11,9,379,112
79605,18,77,31,2,103,3,3,219,115
34128,10,78,202,10,84,15,15,404,7
33716,10,40,21,4,57,1,2,125,6
93921,21,41,323,3,85,15,4,471,150
7018,5,123,44,2,72,6,13,260,245
8544,5,40,205,7,106,13,3,374,248
44933,13,144,23,3,229,4,27,430,31
97666,22,60,163,2,82,10,10,327,167
89759,20,196,65,0,124,2,12,399,139
125567,30,53,199,3,58,0,9,322,224
124944,30,128,87,4,39,5,44,307,221
94320,21,49,240,4,136,18,12,459,151
52523,14,132,187,8,73,7,18,425,41
46554,13,43,93,1,157,5,7,306,34
42932,12,107,11,0,93,0,5,216,26
103842,25,13,12,0,3,0,1,29,180
100470,24,42,264,7,114,12,2,441,174
87410,20,214,25,0,217,1,9,466,143
90301,21,77,99,0,85,6,10,277,148
67929,15,41,75,4,194,10,5,329,81
25504,9,39,97,7,217,16,6,382,278
106278,25,51,108,4,135,12,11,321,185
71543,15,81,85,2,25,1,14,208,91
97893,23,93,64,0,187,7,13,364,168
24221,9,23,122,0,146,10,9,310,275
58989,15,46,166,3,141,14,4,374,95
2120,2,67,182,5,99,19,6,378,131
76232,16,52,102,3,198,14,9,378,99
107665,26,36,250,1,87,15,8,397,188
11329,7,133,25,0,33,1,6,198,258
17801,8,71,124,6,28,17,5,251,270
93846,21,61,323,5,91,10,10,500,150
67845,15,30,48,0,180,15,12,285,81
79944,18,117,29,1,75,1,11,234,115
73918,16,85,35,1,132,0,16,269,105
30328,9,34,215,3,178,11,5,446,290
47453,13,49,185,4,167,27,8,440,36
81029,19,109,294,6,80,21,12,522,121
11593,7,176,125,1,69,1,11,383,259
37262,11,89,210,3,48,2,9,361,19
74106,16,43,167,3,141,13,14,381,105
63440,15,54,151,2,219,16,4,446,67
86956,20,106,22,1,105,4,16,254,142
10889,7,127,126,0,100,3,17,373,257
40757,12,65,38,2,178,4,4,291,22
102952,25,88,75,0,82,11,8,264,179
96058,22,52,59,0,47,2,11,171,164
88453,20,99,76,2,233,11,4,425,146
96830,22,43,186,5,103,7,16,360,165
79965,18,82,43,2,127,14,4,272,115
111440,27,146,12,0,248,6,10,422,198
68730,15,60,59,3,209,11,7,349,83
127630,31,85,193,0,47,15,7,347,236
61176,15,82,113,12,160,10,6,383,62
69194,15,87,205,8,115,22,11,448,84
15742,8,126,46,3,45,4,12,236,266
84697,19,94,185,3,79,11,6,378,119
20317,9,8,75,4,151,9,6,253,285
81577,19,53,197,2,39,4,3,298,122
18107,8,46,88,3,71,8,7,223,271
22000,9,26,86,6,240,24,5,387,297
127022,31,126,166,2,50,7,8,359,234
124986,30,60,79,1,5,1,8,154,222
15544,8,85,46,2,24,7,7,171,266
56614,15,40,175,3,162,23,5,408,68
10297,7,69,14,0,146,0,12,241,253
31420,9,44,202,0,207,16,8,477,292
102847,25,35,59,1,50,6,2,153,179
108388,26,40,215,4,63,4,9,335,190
93359,21,68,213,3,113,14,19,430,163
57840,15,85,80,4,177,13,14,373,92
30851,9,20,38,1,353,15,8,435,291
17761,8,62,196,5,37,13,3,316,270
129197,32,29,64,6,20,4,11,134,239
30759,9,26,64,3,324,15,8,440,291
48548,14,47,38,0,9,3,4,101,49
103344,25,97,21,0,46,0,5,169,180
83487,19,119,114,4,46,4,18,305,127
59229,15,88,96,3,107,8,22,324,96
23130,9,46,117,12,226,0,5,406,299
102320,25,50,36,2,51,0,5,144,178
93947,21,45,193,4,110,12,15,379,150
63718,15,54,145,2,231,16,5,453,69
72811,16,49,63,5,80,7,14,218,102
21832,9,45,250,1,84,16,1,397,296
109270,26,36,106,2,87,6,5,242,192
103230,25,6,13,0,20,3,0,42,179
46432,13,45,56,5,152,7,6,271,34
113225,28,86,57,2,101,9,11,266,201
82969,19,66,131,3,56,13,7,276,126
37292,11,89,230,2,97,17,5,440,20
64407,15,63,159,4,164,15,4,409,71
130189,32,73,142,10,171,19,30,445,240
99736,24,44,210,2,72,28,26,382,172
31443,9,36,302,0,62,4,4,408,292
122205,30,38,175,0,69,6,2,290,215
33502,10,50,111,2,48,4,2,217,6
33855,10,54,124,0,57,4,8,247,7
504,1,45,157,5,54,0,5,266,2
47748,13,98,93,5,199,13,14,422,37
108585,26,38,232,1,55,7,2,335,191
75802,16,36,168,1,118,7,9,339,98
22317,9,26,69,1,256,15,5,372,297
112568,28,43,105,0,83,8,6,245,200
20940,9,43,164,0,212,13,13,445,294
123996,30,167,90,1,168,12,9,447,219
107383,26,93,309,0,73,15,3,493,188
100917,24,49,280,0,104,16,9,458,175
4035,2,67,143,7,66,13,14,310,135
8695,5,79,161,2,119,9,8,378,249
9206,5,43,265,1,26,4,3,342,250
73731,16,40,169,4,55,12,8,288,104
20795,9,24,140,2,108,17,4,295,294
35019,11,48,343,6,52,16,7,472,15
42972,12,57,2,2,191,2,15,269,26
42586,12,75,9,2,71,1,12,170,26
52153,14,64,132,4,58,12,9,279,40
32438,10,95,84,7,45,3,17,251,4
38224,11,35,194,0,44,15,5,293,9
54551,14,84,188,6,58,11,17,364,45
125507,30,87,72,1,62,4,12,238,224
94272,21,53,260,2,150,19,5,489,151
4211,2,59,110,5,89,23,12,298,135
80572,19,22,337,0,22,6,2,389,117
112435,28,47,81,2,91,3,11,235,200
40749,12,54,86,1,165,3,4,313,22
26072,9,34,109,0,232,8,7,390,279
42747,12,47,9,0,228,2,10,296,26
123055,30,67,63,2,213,0,9,354,217
86647,20,160,42,0,115,4,9,330,141
84291,19,66,116,3,45,4,8,242,118
90181,21,25,37,2,262,13,4,343,148
113757,28,78,124,6,98,6,8,320,202
61444,15,33,225,3,145,19,7,432,62
48711,14,68,115,4,26,5,13,231,49
41541,12,26,33,4,132,2,2,199,24
21199,9,26,28,3,206,8,5,276,295
78153,17,74,81,12,172,9,16,364,111
98022,23,153,157,2,96,4,14,426,168
80114,18,105,55,2,93,8,12,275,116
89103,20,77,37,1,108,4,3,230,147
103885,25,96,132,1,32,1,3,265,180
63780,15,50,79,10,256,17,6,418,69
56435,15,76,73,4,184,15,9,361,68
69305,15,48,195,5,96,16,3,363,84
35195,11,44,296,4,28,7,8,387,15
120248,30,55,84,2,150,17,10,318,231
70973,15,32,64,0,225,18,6,345,89
44303,12,67,26,0,74,1,9,177,29
107170,26,53,129,3,63,7,12,267,187
7211,5,79,70,8,217,8,9,391,245
2412,2,118,73,1,44,1,4,241,131
3794,2,56,150,6,52,15,4,283,134
129964,32,72,57,3,106,9,9,256,240
37072,11,113,191,0,11,1,23,339,19
50998,14,53,130,0,57,9,10,259,55
9278,5,97,347,2,60,15,6,527,250
103418,25,32,16,1,85,4,4,142,180
8673,5,174,25,4,143,4,7,357,248
33883,10,75,138,4,64,9,10,300,7
10379,7,85,60,3,227,3,14,392,253
97237,22,30,355,0,99,9,3,496,166
62908,15,72,117,2,194,11,9,405,66
128898,32,53,12,0,36,0,9,110,238
66245,15,81,123,6,117,6,16,349,76
5778,4,190,121,5,98,2,7,423,242
44189,12,46,10,1,99,0,3,159,29
128437,32,91,142,6,54,8,4,305,238
37695,11,37,233,2,38,10,7,327,20
120714,30,44,112,2,59,7,26,250,232
35321,11,50,255,3,38,9,8,363,15
130078,32,16,24,2,85,2,12,141,240
82892,19,91,94,3,57,7,16,268,126
65713,15,54,70,0,162,24,7,317,74
109005,26,14,15,2,24,0,2,57,192
79509,18,46,26,5,117,2,8,204,114
92062,21,49,120,4,107,22,4,306,160
109318,26,53,145,3,111,13,5,330,192
105984,25,45,130,4,154,15,18,366,185
125588,30,176,124,0,56,2,10,368,224
111741,27,42,11,0,116,1,3,173,198
91568,21,47,76,2,130,2,12,269,159
49152,14,93,214,4,11,6,5,333,50
127754,31,112,250,5,78,16,19,480,236
127981,31,57,122,0,3,0,2,184,237
110996,27,189,11,0,133,0,1,334,196
90743,21,229,77,1,50,5,55,417,156
69228,15,73,210,7,114,18,10,432,84
9141,5,94,127,7,49,21,10,308,250
69700,15,66,123,4,68,3,7,271,86
51667,14,88,201,4,56,14,11,374,39
26250,9,65,201,0,173,19,9,467,280
122539,30,150,42,2,108,10,17,329,216
91287,21,96,139,2,76,10,17,340,158
77798,17,106,106,131,58,3,14,418,110
125174,30,57,101,3,118,15,16,310,222
30424,9,39,152,3,267,12,5,478,290
80766,19,93,212,14,67,19,9,414,117
98933,23,52,68,5,132,8,6,271,170
102282,25,48,101,0,30,0,8,187,178
95537,21,103,178,4,104,15,8,412,154
1334,2,78,199,5,70,13,14,379,129
101739,24,68,95,0,79,2,17,261,177
89601,20,60,55,1,52,3,16,187,138
103211,25,85,39,0,70,5,7,206,179
104752,25,227,65,11,66,2,20,391,182
36836,11,109,271,0,22,4,11,417,19
30217,9,26,149,4,242,16,1,438,289
166,1,72,184,5,53,23,15,352,1
121319,30,95,169,4,191,19,7,485,213
74975,16,21,122,2,112,9,8,274,107
63376,15,71,96,2,204,23,19,415,67
63236,15,1,51,1,29,2,0,84,67
12458,7,81,24,0,264,1,7,377,261
9079,5,60,214,0,101,19,8,402,249
19491,8,77,156,18,62,16,2,331,273
115592,28,61,248,4,88,5,4,410,206
47073,13,71,227,2,125,19,3,447,35
58630,15,54,93,4,166,20,10,347,94
48142,14,106,101,2,29,1,6,245,38
120445,30,113,89,1,91,8,20,322,231
79499,18,67,77,2,81,7,4,238,114
32139,10,34,128,3,58,6,10,239,4
26835,9,37,90,1,264,13,10,415,281
20253,9,20,124,2,247,10,8,411,285
123703,30,53,101,3,127,6,8,298,219
103446,25,77,167,3,136,7,8,398,180
22028,9,35,53,6,311,6,14,425,297
93523,21,112,30,2,139,0,11,294,149
108060,26,84,119,2,110,4,12,331,189
134,1,88,154,5,46,9,10,312,1
93774,21,52,270,1,63,4,5,395,150
121276,30,63,120,0,200,13,1,397,213
120964,30,62,102,4,130,21,21,340,213
12236,7,212,12,0,120,1,14,359,260
62526,15,51,109,2,174,14,6,356,65
23386,9,49,155,2,234,11,0,451,299
71310,15,40,83,5,102,7,11,248,91
8503,5,54,61,4,64,2,8,193,248
126093,30,162,40,1,106,2,8,319,225
5832,4,128,137,54,68,2,2,391,242
205,1,70,73,6,94,5,9,257,1
13494,7,58,53,1,156,4,15,287,264
10182,6,91,140,2,84,6,8,331,252
39928,11,29,105,3,90,10,18,255,13
34135,10,65,176,4,81,10,3,339,7
29375,9,70,141,3,452,18,15,699,288
41395,12,73,41,5,114,9,5,247,23
52856,14,104,221,5,40,12,11,393,41
41342,12,50,41,2,62,5,6,166,23
26073,9,43,125,3,211,16,4,402,279
33114,10,31,55,2,4,1,2,95,6
53299,14,59,213,0,98,14,6,390,42
39551,11,30,202,0,19,4,7,262,12
55709,14,41,85,0,6,0,2,134,48
88581,20,57,113,1,164,19,5,359,146
51537,14,96,175,4,68,19,6,368,56
102307,25,55,44,1,20,3,2,125,178
21203,9,22,38,2,190,8,10,270,295
63893,15,46,195,3,133,11,5,393,69
49594,14,118,226,1,17,11,16,389,52
54363,14,59,152,6,68,9,9,303,45
35513,11,45,98,1,25,1,19,189,16
49632,14,115,150,0,16,2,7,290,52
92319,21,82,137,6,140,22,15,402,160
78001,17,62,125,7,135,13,12,354,111
104163,25,93,55,1,118,0,3,270,181
70506,15,63,55,1,192,13,14,338,88
128602,32,41,103,1,189,13,17,364,238
40838,12,5,3,0,39,0,0,47,22
59484,15,54,79,9,214,15,13,384,58
46295,13,68,61,3,56,2,11,201,34
86675,20,50,46,2,145,5,18,266,141
22367,9,61,165,1,209,18,0,454,297
74903,16,55,218,2,156,11,6,448,107
20148,9,30,278,0,221,18,1,548,285
66895,15,60,114,6,194,10,10,394,77
75590,16,13,51,0,121,0,13,198,108
69571,15,88,158,6,102,6,22,382,85
15205,8,114,66,5,65,10,6,266,265
12709,7,25,57,2,81,2,3,170,262
71129,15,70,78,1,181,26,14,370,89
90814,21,131,99,1,107,3,27,368,157
52077,14,86,143,10,99,15,8,361,40
125082,30,66,21,0,220,4,40,351,222
104552,25,60,106,6,170,12,4,358,182
44211,12,150,13,1,120,0,2,286,29
98745,23,64,67,3,145,7,13,299,170
122767,30,58,80,1,137,2,24,302,217
29544,9,28,60,3,325,13,0,429,288
92266,21,57,151,5,116,22,11,362,160
128750,32,60,78,1,111,7,17,274,238
9539,6,88,136,2,105,8,7,346,251
96852,22,63,139,20,95,5,7,329,165
78017,17,29,85,6,106,12,3,241,111
38679,11,62,54,1,176,1,16,310,10
111343,27,235,10,2,213,2,8,470,197
121313,30,50,86,6,121,19,5,287,213
83073,19,15,40,0,15,2,4,76,126
9243,5,104,139,3,50,15,11,322,250
22488,9,46,108,1,229,16,7,407,298
119718,30,89,175,0,106,7,3,380,230
82538,19,50,408,2,43,8,6,517,125
13763,7,40,83,2,161,6,10,302,264
79160,18,73,38,1,57,5,14,188,114
89677,20,195,14,1,171,3,18,402,139
27628,9,29,103,1,261,14,9,417,282
92470,21,82,163,7,114,10,10,386,161
99104,24,71,45,3,71,1,22,213,171
62217,15,37,106,6,171,7,13,340,64
21259,9,24,62,2,261,21,8,378,295
99238,24,61,148,1,39,4,36,289,171
101664,24,2,4,0,9,1,0,16,177
56953,15,136,51,4,110,0,14,315,79
41513,12,80,27,2,64,2,5,180,23
52877,14,84,161,2,71,18,280,616,42
5507,4,92,115,1,132,13,9,362,242
44953,13,86,78,2,126,12,9,313,31
30700,9,17,55,1,305,7,8,393,291
77598,17,46,57,2,159,8,11,283,110
53656,14,83,129,6,43,14,14,289,43
67958,15,29,47,2,132,10,9,229,81
14512,7,84,24,0,26,0,7,141,255
58497,15,35,229,2,151,19,7,443,94
4731,2,55,125,2,36,7,9,234,136
68179,15,46,63,5,225,13,6,358,82
1572,2,95,169,8,93,5,11,381,129
29001,9,12,53,0,81,12,4,162,286
122219,30,71,187,5,73,7,10,353,215
66281,15,84,232,0,97,11,7,431,76
126424,31,110,219,5,109,5,9,457,233
72174,16,43,125,1,150,3,6,328,101
27034,9,24,79,2,387,10,6,508,281
55108,14,92,174,10,79,17,17,389,47
117179,30,93,107,1,137,6,17,361,212
7397,5,43,10,0,24,1,4,82,246
24568,9,30,102,1,209,11,7,360,276
81943,19,60,146,6,54,7,8,281,123
17427,8,116,194,5,81,8,5,409,269
119247,30,39,58,0,107,8,10,222,229
61115,15,45,76,5,170,14,6,316,61
101427,24,52,228,7,93,13,14,407,176
31870,9,50,62,2,254,12,1,381,293
130322,32,50,81,4,98,16,16,265,241
115568,28,54,164,1,79,5,11,314,206
46288,13,46,48,2,25,3,10,134,34
116058,29,9,37,0,52,1,4,103,207
101791,24,49,257,0,59,2,44,411,177
3104,2,71,119,3,71,18,7,289,133
46465,13,130,97,22,145,1,24,419,34
23776,9,45,134,3,168,10,14,374,300
247,1,42,69,7,66,0,4,188,1
58198,15,86,106,6,197,17,21,433,93
11870,7,27,24,0,82,0,10,143,259
60239,15,51,142,2,249,17,5,466,59
13820,7,65,65,1,164,8,6,309,264
124801,30,61,70,0,161,3,58,353,221
93033,21,31,114,4,59,10,10,228,163
124799,30,65,66,3,139,0,55,328,221
118967,30,72,96,0,144,15,15,342,228
94297,21,61,206,1,127,19,5,419,151
75568,16,28,26,4,133,1,8,200,108
55464,14,79,104,20,26,1,6,236,47
4736,2,46,81,2,41,5,3,178,136
56242,15,87,81,8,177,13,7,373,57
81781,19,24,231,0,41,10,8,314,123
64972,15,86,183,5,135,22,10,441,72
64626,15,28,352,0,88,7,2,477,71
101907,24,121,20,2,98,4,39,284,177
125486,30,75,88,1,48,0,9,221,224
60282,15,47,102,2,208,19,16,394,59
130738,32,119,51,7,129,5,5,316,241
92814,21,53,89,2,145,4,19,312,162
30404,9,31,135,1,186,23,4,380,290
44402,12,46,22,3,55,0,7,133,29
2381,2,71,47,2,51,2,3,176,131
68793,15,67,54,2,205,12,15,355,83
66968,15,55,62,4,171,15,5,312,78
125561,30,63,117,0,53,2,8,243,224
90057,21,93,115,1,153,9,16,387,148
56846,15,133,169,8,116,14,15,455,79
86637,20,63,16,2,33,1,4,119,141
124138,30,69,80,8,89,3,10,259,220
35474,11,46,154,3,31,11,13,258,16
49687,14,70,184,5,51,8,11,329,52
103680,25,47,57,1,42,0,4,151,180
98875,23,51,216,2,126,23,8,426,170
94158,21,95,135,7,154,26,15,432,150
69229,15,91,221,14,125,30,10,491,84
122465,30,86,113,7,130,10,21,367,216
23880,9,30,268,0,37,1,2,338,275
31117,9,55,332,1,122,9,8,527,292
92793,21,59,128,1,119,12,13,332,162
95440,21,92,130,4,157,8,18,409,154
17437,8,53,152,1,25,8,2,241,269
70780,15,48,60,7,281,20,14,430,88
13170,7,117,29,2,63,2,6,219,263
116790,29,51,67,5,81,2,8,214,209
95017,21,94,55,3,101,4,18,275,153
73146,16,11,53,0,91,0,3,158,103
53088,14,89,143,4,73,13,11,333,42
29340,9,33,76,3,330,13,10,465,287
29132,9,32,148,3,219,20,4,426,287
22347,9,31,113,2,271,12,6,435,297
125019,30,93,141,3,107,3,14,361,222
30028,9,34,79,3,283,10,6,415,289
92817,21,49,108,1,148,4,21,331,162
58828,15,42,62,3,104,18,7,236,95
90966,21,66,123,3,125,12,11,340,157
15,1,102,104,5,76,4,10,301,1
20785,9,24,148,1,123,9,14,319,294
10354,7,52,36,0,132,2,16,238,253
16706,8,70,65,0,43,9,1,188,268
64786,15,126,72,6,119,8,17,348,72
75977,16,35,156,3,145,16,6,361,98
17268,8,92,51,4,10,2,9,168,269
28136,9,33,84,3,252,12,16,400,284
27763,9,28,75,2,240,10,4,359,283
22949,9,30,135,2,222,11,5,405,299
107973,26,81,195,0,107,7,0,390,189
9171,5,60,153,4,28,13,7,265,250
6771,5,72,91,5,23,2,3,196,244
31760,9,41,67,1,276,11,9,405,293
36265,11,32,362,1,27,4,3,429,17
25094,9,40,53,2,193,8,7,303,277
88644,20,59,95,4,271,13,4,446,146
18366,8,27,3,1,16,1,2,50,271
121038,30,74,91,0,159,15,12,351,213
129476,32,19,4,1,15,0,1,40,239
58103,15,68,213,0,187,26,8,502,93
121532,30,81,117,0,252,10,9,469,214
82021,19,83,247,5,56,15,0,406,123
94675,21,30,129,4,106,14,8,291,152
45945,13,128,73,3,104,8,12,328,33
123682,30,104,139,1,57,1,2,304,219
83696,19,101,145,7,52,7,10,322,127
118805,30,65,120,0,119,5,10,319,228
78518,17,87,71,5,172,21,16,372,112
99081,24,72,102,2,43,4,14,237,171
3577,2,50,103,7,36,8,5,209,134
71920,16,81,25,1,153,0,5,265,97
17993,8,85,300,8,51,7,3,454,270
71337,15,30,62,13,289,13,13,420,91
108657,26,51,128,8,127,14,5,333,191
47523,13,42,128,6,139,16,6,337,37
6022,4,67,87,1,115,0,5,275,243
127279,31,96,235,1,71,7,19,429,235
21817,9,31,281,1,171,18,8,510,296
72345,16,32,28,1,127,4,3,195,101
111725,27,141,11,0,83,4,4,243,198
96093,22,139,106,1,43,0,11,300,164
27032,9,27,44,5,253,14,8,351,281
97817,22,38,214,2,99,18,2,373,167
45248,13,129,209,6,147,3,35,529,31
50313,14,47,330,4,52,21,1,455,53
97220,22,62,237,0,120,15,0,434,166
116978,29,62,99,2,222,15,10,410,209
7613,5,63,133,3,65,6,4,274,246
68430,15,51,32,5,191,15,17,311,82
125682,30,103,82,0,119,3,7,314,224
112428,28,52,75,1,41,4,7,180,200
6499,5,54,74,6,26,4,12,176,244
32286,10,58,161,3,26,1,6,255,4
23201,9,60,132,4,212,24,9,441,299
53585,14,100,165,5,69,14,8,361,43
25601,9,44,135,3,298,31,8,519,278
92972,21,4,32,0,27,2,0,65,163
60773,15,48,87,5,238,23,12,413,61
84221,19,39,137,9,51,12,7,255,118
106326,25,38,61,1,75,4,9,188,185
85610,20,53,68,0,122,3,10,256,137
61737,15,36,304,0,114,11,4,469,63
57930,15,54,82,5,207,24,14,386,92
27153,9,25,50,3,285,19,6,388,281
19637,8,106,153,5,33,0,7,304,273
13161,7,62,5,0,48,1,8,124,263
88504,20,58,66,0,237,11,5,377,146
111305,27,163,35,0,179,6,1,384,197
70370,15,52,110,6,138,26,6,338,87
95257,21,90,37,1,71,3,12,214,153
56183,15,101,134,4,149,5,10,403,57
90083,21,64,98,1,143,11,11,328,148
96279,22,94,193,0,71,6,12,376,164
122209,30,32,129,3,63,11,6,244,215
85382,19,127,172,6,83,8,6,402,120
6061,4,79,78,0,104,5,9,275,243
74134,16,23,117,0,140,7,13,300,105
56120,15,188,66,4,65,7,31,361,57
48803,14,149,207,5,28,8,21,418,50
39186,11,32,266,1,45,9,11,364,11
33400,10,81,137,6,52,1,22,299,6
117764,30,25,62,1,38,1,10,137,223
5795,4,131,216,33,85,45,22,532,242
40038,11,22,62,2,114,2,11,213,13
56970,15,82,187,9,63,2,22,365,79
59765,15,55,89,6,265,12,8,435,58
45040,13,96,60,6,109,4,18,293,31
102328,25,72,72,0,54,1,5,204,178
104025,25,158,57,1,105,9,6,336,181
93675,21,50,180,4,120,17,10,381,149
67021,15,51,47,2,186,26,10,322,78
16204,8,61,123,4,54,6,5,253,267
108837,26,14,110,4,111,12,6,257,191
8553,5,41,204,0,73,14,5,337,248
22996,9,39,148,5,271,11,6,480,299
102795,25,50,152,3,68,5,0,278,179
80981,19,141,76,1,37,6,11,272,121
100609,24,53,137,5,76,4,25,300,174
124339,30,80,164,3,168,13,11,439,220
5267,3,89,76,3,132,3,4,307,211
6834,5,87,79,9,120,6,10,311,245
82398,19,65,50,2,146,2,25,290,124
100086,24,126,70,4,23,2,19,244,173
20486,9,23,144,0,128,11,3,309,285
4665,2,68,116,3,45,4,10,246,136
72710,16,107,42,0,160,1,2,312,102
29263,9,35,93,4,263,24,8,427,287
57997,15,47,118,5,167,23,5,365,93
48699,14,115,134,7,62,9,19,346,49
5885,4,52,53,7,73,1,13,199,242
67242,15,43,89,3,223,14,3,375,78
92096,21,44,137,1,135,21,12,350,160
70784,15,45,161,2,233,26,11,478,88
128996,32,78,49,3,47,3,2,182,239
95844,21,57,59,1,56,1,12,186,155
40217,11,25,176,2,36,8,17,264,13
104722,25,49,143,3,51,8,4,258,182
27870,9,72,119,4,297,20,4,516,283
119462,30,25,100,3,86,8,14,236,229
129735,32,71,6,0,75,0,5,157,240
128717,32,27,25,0,43,1,6,102,238
112036,28,49,122,3,52,7,0,233,199
129243,32,17,57,0,59,2,5,140,239
41729,12,48,55,2,214,9,6,334,24
113959,28,123,69,2,71,1,6,272,203
73772,16,41,124,2,64,7,16,254,104
130657,32,87,6,3,118,3,10,227,241
107246,26,100,428,3,195,18,4,748,187
19717,8,26,20,0,9,0,0,55,273
55863,14,97,107,1,46,4,5,260,48
121880,30,64,219,2,104,22,15,426,215
57278,15,85,109,4,181,16,5,400,90
87143,20,50,12,0,24,0,2,88,142
114956,28,77,174,1,47,3,14,316,205
70174,15,99,149,9,125,20,7,409,87
14432,7,79,45,1,152,4,10,291,255
68939,15,92,156,6,71,22,6,353,84
10026,6,76,276,2,108,16,2,480,252
86479,20,23,26,1,230,4,7,291,141
125629,30,102,131,0,76,3,10,322,224
14063,7,73,38,2,138,0,13,264,254
12391,7,88,31,3,155,3,5,285,261
125013,30,67,106,0,114,5,14,306,222
48319,14,45,88,0,44,0,5,182,38
15630,8,39,40,1,28,3,3,114,266
11785,7,208,21,2,132,1,19,383,259
99282,24,46,142,4,19,5,26,242,171
118823,30,76,21,0,44,0,6,147,228
12876,7,182,46,0,43,1,17,289,262
100895,24,43,240,2,76,15,11,387,175
124073,30,94,99,1,24,3,6,227,220
53711,14,82,160,5,108,24,14,393,43
34172,10,60,142,2,116,16,6,342,7
12203,7,64,11,11,28,3,9,126,260
100827,24,55,217,0,103,28,11,414,175
6783,5,79,148,3,22,6,5,263,244
61394,15,49,131,6,165,9,5,365,62
61800,15,28,277,3,79,15,5,407,63
82668,19,80,263,6,62,11,9,431,125
2087,2,26,68,0,52,4,6,156,131
107855,26,71,60,1,338,7,11,488,189
86796,20,93,49,0,129,4,4,279,142
82763,19,88,197,9,84,15,3,396,125
25763,9,31,168,3,198,19,10,429,278
109926,27,101,8,1,201,0,5,316,194
35750,11,89,171,3,21,4,13,301,16
33885,10,82,170,2,99,18,13,384,7
116791,29,32,143,2,131,9,19,336,209
77967,17,62,91,3,179,12,7,354,111
40084,11,47,159,4,89,10,11,320,13
87212,20,112,29,0,139,4,9,293,143
60318,15,57,41,6,156,12,7,279,60
91002,21,71,199,3,92,13,15,393,157
13847,7,104,58,4,107,2,12,287,254
85842,20,181,165,0,62,2,11,421,137
87547,20,122,21,1,54,0,11,209,144
76294,16,37,57,2,138,4,13,251,99
81959,19,50,189,7,37,13,6,302,123
112510,28,50,128,2,89,10,7,286,200
30348,9,37,108,0,204,12,6,367,290
129925,32,21,30,2,96,0,1,150,240
11504,7,125,24,0,42,3,9,203,259
38960,11,65,181,4,41,8,8,307,10
24997,9,23,28,0,161,8,5,225,277
121315,30,53,66,3,133,12,9,276,213
8607,5,89,125,7,121,14,13,369,248
4923,3,29,84,5,98,3,4,223,210
114913,28,143,172,1,131,1,9,457,204
19143,8,49,147,3,29,8,9,245,272
53504,14,89,199,3,61,15,17,384,43
116557,29,58,154,4,189,29,18,452,208
84207,19,152,95,3,25,1,39,315,128
16989,8,6,7,0,2,0,0,15,269
23160,9,64,195,0,208,24,11,502,299
3492,2,45,153,11,61,19,8,297,134
104520,25,59,74,2,61,8,6,210,182
68660,15,43,47,5,227,17,13,352,83
39496,11,43,204,2,44,8,6,307,12
62376,15,43,92,2,196,13,5,351,64
78293,17,69,123,25,184,3,24,428,112
126828,31,99,160,3,66,4,13,345,234
85172,19,154,145,5,26,1,12,343,120
94706,21,47,122,1,103,12,9,294,152
4182,2,71,67,5,46,10,8,207,135
7877,5,90,231,6,84,27,6,444,247
89413,20,29,24,1,64,2,10,130,138
59439,15,91,49,1,203,2,12,358,96
106561,26,65,147,2,85,6,5,310,186
42268,12,72,253,3,346,17,11,702,25
113656,28,78,110,4,68,11,14,285,202
12577,7,56,82,8,185,0,9,340,261
69858,15,143,55,1,29,0,6,234,86
3824,2,45,151,1,67,11,6,281,134
80258,18,141,158,2,56,3,13,373,116
119535,30,72,32,3,170,2,8,287,229
10786,7,63,0,0,119,0,14,196,257
8388,5,32,310,1,82,6,4,435,248
127475,31,128,61,1,50,2,16,258,235
123910,30,67,136,5,107,9,13,337,219
105245,25,133,202,2,34,1,15,387,183
59671,15,46,119,2,232,15,12,426,58
113749,28,70,122,5,101,6,13,317,202
81188,19,155,178,7,58,13,9,420,121
126043,30,88,92,0,143,2,14,339,225
56777,15,97,195,13,122,22,13,462,79
15567,8,65,107,3,47,1,5,228,266
122962,30,44,48,0,144,6,6,248,217
112520,28,83,136,5,99,9,22,354,200
27645,9,36,112,1,251,14,8,422,282
32763,10,79,136,4,89,15,13,336,5
65600,15,53,72,2,138,13,15,293,74
45590,13,69,28,3,134,4,10,248,32
76630,16,80,91,1,125,5,10,312,100
66246,15,57,114,4,139,11,8,333,76
32766,10,88,90,2,90,10,4,284,5
81214,19,120,179,4,67,22,15,407,121
68509,15,39,78,5,110,11,6,249,83
473,1,84,177,6,86,19,7,379,2
69426,15,52,81,5,47,5,7,197,85
54801,14,83,154,5,111,9,16,378,46
12441,7,71,13,3,85,5,16,193,261
81957,19,71,177,8,38,10,8,312,123
130027,32,55,122,2,135,2,16,332,240
50989,14,92,188,5,105,23,10,423,55
32199,10,17,84,6,12,1,2,122,4
32181,10,65,156,1,20,3,7,252,4
118293,30,61,124,3,29,1,7,225,226
14824,7,74,59,1,151,4,16,305,256
30346,9,32,94,2,245,13,11,397,290
24202,9,26,71,3,216,12,6,334,275
76497,16,72,46,2,118,7,13,258,99
108077,26,51,125,4,117,7,6,310,189
34961,11,64,102,1,104,8,42,321,14
110499,27,115,9,0,194,1,2,321,195
53529,14,113,224,5,86,26,15,469,43
88498,20,57,55,4,175,14,6,311,146
106770,26,48,96,6,94,4,4,252,186
23952,9,30,159,0,137,12,4,342,275
122474,30,74,72,4,92,9,29,280,216
47378,13,74,123,5,147,31,10,390,36
76858,16,16,12,0,105,0,1,134,100
29219,9,37,91,9,339,17,15,508,287
26314,9,38,267,2,126,17,6,456,280
95292,21,113,23,2,107,4,30,279,153
12961,7,57,184,2,88,2,1,334,262
27228,9,20,76,0,259,16,7,378,281
30973,9,82,262,4,379,26,7,760,291
51463,14,104,200,6,83,19,14,426,56
53295,14,49,154,3,51,8,4,269,42
25466,9,37,88,2,272,11,9,419,278
19756,9,2,24,0,38,3,0,67,274
3560,2,69,85,1,37,9,8,209,134
91786,21,94,181,6,102,20,11,414,159
102710,25,45,31,0,3,0,5,84,178
57222,15,51,71,3,123,14,7,269,90
65879,15,61,264,9,72,15,5,426,75
51332,14,72,160,7,77,13,13,342,56
70572,15,62,59,3,162,15,10,311,88
128475,32,27,57,3,97,10,5,199,238
54629,14,74,169,1,21,7,11,283,46
27031,9,9,54,2,275,16,7,363,281
10157,6,113,137,2,60,5,7,324,252
129702,32,3,41,0,27,1,72,144,240
102394,25,84,76,4,46,4,8,222,178
26141,9,30,52,2,356,11,9,460,279
107532,26,63,234,5,88,14,10,414,188
20002,9,41,90,5,333,17,9,495,274
118560,30,59,195,0,119,18,6,397,227
79565,18,119,51,7,176,14,11,378,115
113454,28,48,174,0,25,2,1,250,202
127043,31,94,118,1,49,3,3,268,234
113019,28,82,96,0,57,3,23,261,201
25066,9,43,41,1,168,7,7,267,277
13762,7,69,73,2,152,6,0,302,264
106725,26,42,157,8,56,7,7,277,186
38766,11,67,90,2,13,0,2,174,10
9218,5,49,289,3,59,14,2,416,250
79845,18,93,62,10,155,10,11,341,115
13037,7,104,23,0,66,0,4,197,263
122495,30,54,141,4,58,0,5,262,216
12610,7,104,30,2,109,5,16,266,261
56102,15,45,228,1,101,10,13,398,57
10541,7,123,16,0,86,3,17,245,253
59172,15,174,94,9,84,3,19,383,96
128264,31,170,157,1,58,3,14,403,237
4993,3,66,108,5,146,10,5,340,210
78812,17,60,95,11,219,16,14,415,113
114767,28,30,68,2,64,1,2,167,204
47334,13,60,112,6,154,23,11,366,36
31318,9,34,98,2,382,15,8,539,292
37312,11,49,159,0,80,11,4,303,20
68902,15,82,51,7,192,12,18,362,83
110541,27,112,19,4,265,3,14,417,195
19558,8,45,186,13,32,15,7,298,273
101207,24,16,96,0,14,0,18,144,175
12372,7,126,61,3,74,2,12,278,261
112367,28,52,153,1,96,7,11,320,200
6275,4,110,55,8,19,0,11,203,243
17972,8,107,136,2,28,4,4,281,270
77062,17,60,152,1,182,23,9,427,109
71658,16,111,21,1,216,0,3,352,97
9314,5,47,160,2,56,8,7,280,250
105237,25,22,102,1,13,0,2,140,183
43826,12,91,58,4,101,10,11,275,28
103027,25,103,123,2,73,11,1,313,179
111251,27,100,3,0,201,0,2,306,197
85692,20,106,114,1,186,14,4,425,137
101194,24,32,365,0,89,20,3,509,175
95245,21,75,21,6,124,4,8,238,153
68415,15,57,63,4,219,21,15,379,82
18567,8,5,92,1,56,46,14,214,271
130112,32,69,65,6,116,18,55,329,240
62577,15,70,77,3,237,13,10,410,65
47008,13,75,48,1,139,2,6,271,35
36651,11,76,197,4,38,12,12,339,18
61202,15,60,116,9,215,29,24,453,62
2779,2,66,109,5,72,5,5,262,132
103986,25,46,72,6,113,0,9,246,181
75645,16,37,148,3,170,4,14,376,98
68476,15,46,61,8,249,15,12,391,82
32300,10,130,104,1,16,0,3,254,4
121704,30,65,47,1,245,5,10,373,214
96687,22,121,217,3,34,4,8,387,165
24688,9,30,83,0,143,10,1,267,276
127701,31,113,237,3,106,15,7,481,236
83052,19,38,66,2,43,6,2,157,126
11542,7,48,21,1,35,0,3,108,259
39416,11,59,116,13,46,5,11,250,11
73350,16,25,66,0,110,2,8,211,103
97967,23,51,129,3,155,15,13,366,168
17316,8,28,86,4,27,3,6,154,269
35287,11,17,397,2,46,8,3,473,15
25926,9,21,57,0,318,11,5,412,279
19054,8,53,56,2,16,8,9,144,272
38561,11,117,159,7,107,15,14,419,9
47721,13,32,97,1,145,17,2,294,37
24061,9,22,134,2,227,15,5,405,275
49495,14,157,157,5,71,11,24,425,51
63058,15,120,104,2,111,7,2,346,66
107045,26,42,158,3,31,0,7,241,187
19451,8,90,124,3,24,2,8,251,273
74505,16,77,79,1,119,2,11,289,106
92257,21,80,158,12,128,17,12,407,160
67481,15,30,62,4,155,12,2,265,80
130122,32,43,185,2,118,16,7,371,240
70620,15,45,155,3,179,21,6,409,88
117858,30,119,278,0,49,0,11,457,223
17863,8,77,285,5,52,7,4,430,270
44254,12,84,0,0,55,0,3,142,29
60949,15,73,129,3,153,18,12,388,61
36208,11,65,277,5,28,10,18,403,17
36439,11,47,313,6,34,10,19,429,18
94972,21,56,110,1,34,1,17,219,152
72935,16,34,211,0,63,0,2,310,103
114228,28,82,116,3,95,2,8,306,203
104370,25,42,81,2,84,0,12,221,182
125632,30,113,115,1,73,7,8,317,224
103150,25,90,47,1,46,5,3,192,179
16069,8,43,98,0,40,2,1,184,267
52114,14,75,182,0,82,19,4,362,40
51524,14,92,213,6,83,26,2,422,56
74435,16,80,32,1,198,1,4,316,106
19845,9,22,61,1,303,4,6,397,274
14424,7,131,6,1,22,0,3,163,255
129134,32,95,261,7,178,19,21,581,239
124251,30,81,66,2,64,1,17,231,220
115488,28,79,194,2,72,19,15,381,206
45810,13,65,113,7,151,21,5,362,33
118165,30,117,133,3,90,3,16,362,226
44852,13,46,35,0,146,0,8,235,31
49259,14,93,187,7,81,14,8,390,51
17981,8,25,114,1,5,1,8,154,270
16489,8,58,106,0,41,0,8,213,268
5045,3,56,151,5,205,20,6,443,210
40707,12,51,30,2,64,1,6,154,22
45601,13,85,78,12,149,8,7,339,32
87470,20,125,62,1,177,4,20,389,143
34212,10,85,74,0,60,4,11,234,7
98314,23,101,26,0,80,0,9,216,169
124311,30,47,158,1,87,6,12,311,220
117639,30,52,7,1,53,1,7,121,223
75221,16,94,55,5,168,5,5,332,108
55525,14,97,147,19,76,66,23,428,47
39823,11,25,108,3,83,2,7,228,12
110813,27,139,15,1,237,3,6,401,196
73641,16,45,87,0,88,6,13,239,104
117386,30,46,96,1,122,2,16,283,212
106104,25,39,102,1,70,8,10,230,185
12096,7,107,131,1,147,9,5,400,260
125759,30,96,69,1,89,4,18,277,224
77858,17,33,82,6,151,16,7,295,111
109874,27,115,22,0,202,0,10,349,194
60830,15,41,143,0,197,8,2,391,61
84664,19,110,147,10,83,12,9,371,119
61126,15,46,74,0,148,13,4,285,61
112424,28,46,134,1,68,5,2,256,200
13167,7,92,41,4,71,4,17,229,263
9200,5,85,83,3,97,11,18,297,250
40237,11,28,80,1,98,8,12,227,13
60260,15,58,36,1,138,22,4,259,59
121930,30,47,138,1,73,9,5,273,215
106155,25,50,149,3,97,16,14,329,185
17791,8,66,102,2,32,7,14,223,270
113965,28,111,54,0,57,0,10,232,203
33044,10,82,76,2,77,3,9,249,5
106657,26,34,118,3,48,5,4,212,186
66498,15,108,205,1,83,11,7,415,76
16324,8,43,80,2,25,7,3,160,267
87795,20,51,33,3,124,8,2,221,144
89888,20,40,10,2,150,2,4,208,139
13960,7,75,66,0,56,1,16,214,254
10536,7,73,12,0,182,4,21,292,253
103971,25,62,97,1,51,5,3,219,181
17342,8,60,213,7,41,6,7,334,269
61615,15,38,248,4,166,21,7,484,63
23256,9,33,87,3,169,13,8,313,299
115049,28,103,140,2,59,6,28,338,205
75151,16,20,52,0,10,0,5,87,107
65320,15,38,288,1,62,8,1,398,73
34560,11,13,55,1,14,1,9,93,8
12128,7,107,45,1,178,8,7,346,260
24713,9,45,66,5,253,11,10,390,276
51022,14,62,142,4,52,10,9,279,55
91580,21,109,33,2,97,4,19,264,159
49368,14,87,259,6,119,29,0,500,51
90327,21,95,119,4,104,3,29,354,148
108989,26,83,194,3,50,0,6,336,192
127174,31,53,189,2,50,5,4,303,235
43007,12,72,9,0,32,0,1,114,27
64662,15,70,122,3,180,16,14,405,71
16029,8,50,127,2,31,7,1,218,267
102206,25,50,52,1,7,0,0,110,178
6502,5,9,1,0,3,0,0,13,244
32896,10,88,116,1,68,7,20,300,5
67746,15,44,102,6,306,20,7,485,80
61164,15,60,112,7,172,16,10,377,62
47742,13,34,77,3,151,14,4,283,37
34708,11,66,205,1,38,9,33,352,14
68901,15,96,53,7,203,20,7,386,83
49760,14,70,156,2,79,7,5,319,52
71891,16,46,69,1,231,4,7,358,97
65132,15,143,80,4,40,5,20,292,72
83890,19,115,76,3,32,43,32,301,128
7927,5,77,146,5,75,12,11,326,247
7795,5,89,104,3,52,5,9,262,246
20650,9,35,99,1,248,14,12,409,294
38768,11,133,111,2,11,3,11,271,10
66443,15,60,206,7,141,18,7,439,76
92502,21,52,60,1,176,2,15,306,161
52160,14,94,201,7,111,14,4,431,40
122787,30,34,49,4,22,3,6,118,217
112723,28,53,154,2,61,17,11,298,200
112593,28,65,177,2,117,10,8,379,200
48783,14,167,175,0,45,5,9,401,50
70268,15,102,117,3,196,13,9,440,87
92286,21,60,183,4,176,16,11,450,160
91470,21,100,67,14,46,2,32,261,158
18774,8,67,127,2,50,13,10,269,272
28316,9,29,62,0,269,0,4,364,284
114546,28,105,115,10,77,5,11,323,204
126607,31,148,112,2,155,0,19,436,233
118503,30,79,194,2,70,8,5,358,227
1344,2,63,132,4,45,17,5,266,129
70800,15,65,83,2,150,15,15,330,88
8354,5,54,30,0,12,0,6,102,248
54993,14,117,207,4,67,5,12,412,46
101332,24,38,236,1,59,21,9,364,176
76976,16,54,16,0,57,2,4,133,100
5153,3,90,93,1,194,9,9,396,211
85187,19,85,135,1,74,3,9,307,120
102490,25,44,18,0,38,0,3,103,178
11039,7,136,22,0,90,1,19,268,258
111059,27,145,6,0,258,1,9,419,197
94319,21,59,349,1,79,13,4,505,151
18681,8,96,226,5,66,13,5,411,272
586,1,106,112,3,85,19,2,327,2
68365,15,50,86,4,244,18,9,411,82
122654,30,156,141,5,48,1,11,362,216
112659,28,57,202,2,86,8,14,369,200
53707,14,111,128,1,61,14,12,327,43
67169,15,40,48,3,153,8,7,259,78
122945,30,81,63,1,212,15,4,376,217
23360,9,43,112,3,217,11,7,393,299
75549,16,38,219,2,129,17,5,410,108
108352,26,65,172,3,48,10,10,308,190
86535,20,48,30,3,168,5,9,263,141
89607,20,44,28,3,54,6,23,158,138
102109,25,119,53,0,43,1,4,220,178
106934,26,64,58,1,29,0,5,157,187
39605,11,49,246,8,68,14,14,399,12
109607,27,85,1,0,292,1,16,395,193
56725,15,105,81,0,82,3,10,281,68
104932,25,101,30,6,61,2,6,206,182
328,1,65,150,4,60,7,8,294,1
106871,26,101,122,3,75,8,8,317,187
119935,30,34,18,0,4,0,3,59,230
111549,27,124,5,1,233,2,0,365,198
28913,9,32,106,2,218,20,4,382,286
60168,15,54,104,2,212,20,8,400,59
39250,11,35,214,1,56,13,1,320,11
113146,28,89,67,1,148,4,16,325,201
96945,22,45,96,4,39,4,9,197,165
13673,7,79,166,3,165,14,3,430,264
16231,8,57,151,4,50,10,5,277,267
118347,30,60,194,0,74,11,4,343,227
13906,7,42,40,3,135,4,4,228,254
35143,11,60,236,1,16,15,5,333,15
10663,7,122,49,2,102,3,8,286,257
24466,9,46,96,4,240,13,14,413,276
89815,20,105,5,1,95,0,11,217,139
39734,11,65,195,5,114,27,8,414,12
95655,21,86,69,3,119,1,15,293,154
94536,21,43,236,4,134,29,14,460,151
26419,9,37,163,1,207,19,9,436,280
122686,30,170,216,9,51,4,14,464,216
87709,20,57,13,1,44,5,25,145,144
8871,5,113,126,2,113,6,3,363,249
87555,20,19,4,3,52,2,2,82,144
84235,19,58,128,5,43,7,9,250,118
50323,14,99,314,2,55,8,3,481,53
33059,10,58,94,3,48,4,3,210,5
99488,24,97,78,0,48,5,21,249,171
1648,2,65,92,1,50,7,10,225,130
2487,2,58,136,4,110,21,3,332,131
91926,21,79,226,3,166,18,11,503,160
31972,9,32,49,4,305,6,3,399,293
23769,9,46,252,3,128,9,10,448,300
78857,17,105,115,7,128,2,13,370,113
36067,11,86,302,4,59,16,17,484,17
97870,23,45,63,6,190,2,13,319,168
40455,12,57,12,0,107,3,1,180,22
30913,9,32,44,2,273,14,7,372,291
123477,30,52,166,3,139,16,12,388,218
111617,27,186,10,1,245,2,18,462,198
58453,15,62,153,6,163,27,6,417,94
83084,19,118,117,6,44,4,8,297,126
115610,28,45,299,2,48,8,1,403,206
998,1,74,264,3,60,18,3,422,3
103146,25,111,44,2,24,1,0,182,179
2973,2,35,113,3,80,19,9,259,133
116620,29,51,143,3,186,15,11,409,208
76517,16,114,19,0,53,2,11,199,99
76536,16,50,73,31,70,5,12,241,99
95572,21,81,127,4,111,6,12,341,154
73173,16,25,29,2,117,2,6,181,103
65222,15,68,70,26,147,14,9,334,73
29022,9,39,60,2,281,10,6,398,287
25243,9,81,106,0,301,11,0,499,277
67896,15,40,57,3,168,13,4,285,81
13402,7,107,15,0,28,0,9,159,263
6447,5,77,98,4,79,9,9,276,244
68241,15,54,44,4,237,14,12,365,82
65861,15,81,312,4,121,19,8,545,75
69601,15,43,54,7,39,9,5,157,85
128728,32,5,9,0,28,1,0,43,238
1902,2,61,185,4,66,11,9,336,130
48149,14,87,190,3,37,0,22,339,38
126479,31,61,171,2,37,5,10,286,233
57568,15,108,62,7,167,22,10,376,92
40105,11,70,197,5,101,13,6,392,13
85391,19,70,6,0,58,3,4,141,120
86880,20,53,9,0,95,5,12,174,142
19828,9,19,38,3,208,9,10,287,274
62151,15,57,90,3,220,19,11,400,64
93782,21,60,231,4,166,13,8,482,150
91133,21,95,153,2,70,4,17,341,157
46100,13,71,15,1,83,1,9,180,33
14122,7,9,7,0,18,0,2,36,254
5126,3,54,44,1,105,7,10,221,211
104611,25,66,130,3,171,19,2,391,182
27620,9,23,114,2,306,12,7,464,282
64261,15,66,114,4,129,16,8,337,70
40711,12,14,8,1,10,0,2,35,22
16483,8,69,140,4,39,17,5,274,268
120683,30,101,80,1,122,5,18,327,232
23657,9,32,113,2,216,17,5,385,300
1828,2,64,148,2,51,15,7,287,130
111402,27,141,13,0,218,2,6,380,198
22019,9,35,54,3,193,14,8,307,297
98238,23,206,44,4,203,2,11,470,168
17155,8,88,118,5,86,7,7,311,269
14403,7,47,154,0,55,4,13,273,255
76175,16,79,33,3,120,2,14,251,99
4119,2,74,97,4,70,7,14,266,135
52097,14,62,115,5,41,10,16,249,40
12843,7,111,47,1,148,2,12,321,262
21068,9,23,67,2,239,10,5,346,294
47675,13,96,44,4,164,5,45,358,37
79656,18,133,65,10,125,9,13,355,115
34004,10,65,185,3,84,21,6,364,7
34297,11,28,137,0,22,10,11,208,8
119549,30,85,165,1,62,0,6,319,229
43589,12,73,21,2,111,1,11,219,28
1730,2,40,81,2,47,8,5,183,130
8032,5,106,50,0,47,1,9,213,247
79821,18,110,106,4,197,23,4,444,115
86334,20,64,107,0,212,11,4,398,141
85660,20,86,59,0,220,1,7,373,137
129212,32,21,33,0,22,0,5,81,239
106114,25,45,95,4,84,15,11,254,185
110979,27,119,9,0,257,0,5,390,196
52203,14,86,184,11,83,15,13,392,40
69003,15,94,216,4,101,17,5,437,84
44976,13,95,50,5,225,0,10,385,31
44780,12,75,72,1,184,1,19,352,30
84459,19,154,155,1,58,12,18,398,118
89126,20,50,77,5,187,18,9,346,147
3846,2,49,195,6,81,17,1,349,134
6063,4,127,295,2,322,11,3,760,243
100055,24,66,147,45,43,3,44,348,173
83984,19,113,195,10,52,6,6,382,128
78883,17,38,38,5,230,6,20,337,113
95125,21,53,35,1,60,1,11,161,153
99852,24,114,132,0,5,1,28,280,172
48589,14,105,79,4,215,3,21,427,49
31020,9,28,41,3,277,15,3,367,291
55329,14,66,143,1,78,6,15,309,47
75818,16,40,193,1,155,8,6,403,98
44425,12,45,57,3,134,6,13,258,30
77141,17,44,165,4,163,9,6,391,109
109979,27,95,12,0,219,0,7,333,194
86538,20,71,36,0,86,1,13,207,141
84324,19,38,248,2,55,12,3,358,118
55755,14,62,132,6,111,30,9,350,48
96037,21,47,65,5,124,1,47,289,155
79269,18,67,26,1,63,0,9,166,114
100357,24,78,148,2,30,6,13,277,173
36561,11,61,205,0,23,6,10,305,18
2138,2,44,118,2,68,10,11,253,131
77225,17,57,118,6,161,14,12,368,109
91338,21,110,35,5,161,3,34,348,158
43344,12,32,6,0,24,0,1,63,27
126580,31,131,159,0,119,7,15,431,233
106632,26,35,72,0,41,3,5,156,186
93581,21,54,267,0,127,17,4,469,149
91839,21,91,105,5,145,13,7,366,159
39868,11,4,50,0,213,9,9,285,12
19381,8,130,26,9,19,1,9,194,273
11244,7,37,6,2,62,2,6,115,258
609,1,104,148,2,76,20,10,360,2
18179,8,57,52,1,59,4,11,184,271
30209,9,43,141,2,234,13,5,438,289
119050,30,49,131,5,123,8,10,326,228
90826,21,19,36,0,164,0,12,231,157
100744,24,55,111,0,31,0,24,221,174
82297,19,142,148,13,80,18,8,409,124
10672,7,170,38,1,119,1,8,337,257
26960,9,33,39,4,256,8,15,355,281
73724,16,32,106,6,56,4,4,208,104
62532,15,44,53,1,174,19,6,297,65
21503,9,34,226,1,234,26,8,529,295
43585,12,95,27,4,165,2,11,304,28
108994,26,94,218,1,36,1,5,355,192
60146,15,49,130,1,187,13,8,388,59
21888,9,30,145,1,267,13,10,466,296
88109,20,129,7,0,131,0,1,268,145
87346,20,250,3,1,198,0,10,462,143
57238,15,94,135,4,135,22,5,395,90
116656,29,31,98,4,206,16,7,362,209
115293,28,75,215,5,134,15,5,449,205
44983,13,84,30,5,173,4,11,307,31
42022,12,86,7,1,195,2,1,292,24
10032,6,121,209,2,112,19,7,470,252
5359,3,87,18,2,111,7,8,233,211
96372,22,96,127,0,19,1,13,256,164
129179,32,7,7,1,23,0,2,40,239
122082,30,57,209,1,143,11,10,431,215
9592,6,97,176,2,94,12,5,386,251
114582,28,81,97,10,67,2,23,280,204
116247,29,65,124,4,174,9,11,387,208
49434,14,137,193,5,62,14,13,424,51
1309,2,44,156,1,51,4,5,261,129
111282,27,161,8,1,218,0,13,401,197
27837,9,25,46,1,155,16,3,246,283
53917,14,80,147,1,54,3,12,297,44
31250,9,20,35,1,206,4,9,275,292
126726,31,122,127,1,50,2,5,307,234
8840,5,63,188,1,84,3,7,346,249
74742,16,59,312,3,240,16,5,635,106
40487,12,1,5,0,35,0,3,44,22
27296,9,34,186,7,261,25,10,523,282
106723,26,46,122,2,67,9,5,251,186
45042,13,139,22,3,102,0,11,277,31
46515,13,88,78,5,132,11,2,316,34
25881,9,36,97,1,296,16,10,456,279
79747,18,88,73,3,180,15,8,367,115
115686,28,116,143,4,125,10,26,424,206
33574,10,29,62,0,22,1,9,123,6
15048,8,90,103,2,59,5,5,264,265
62936,15,73,76,2,182,15,9,357,66
94010,21,65,136,5,104,9,16,335,150
122352,30,95,142,5,68,3,7,320,216
93470,21,32,141,4,104,6,11,298,149
64320,15,56,41,1,91,7,9,205,70
17811,8,105,259,6,69,17,12,468,270
34729,11,39,147,2,59,3,19,269,14
65560,15,85,79,3,185,15,14,381,74
77982,17,55,246,3,420,21,15,760,111
12419,7,178,166,2,65,0,5,416,261
100749,24,121,234,1,18,2,34,410,174
44761,12,43,113,2,164,12,9,343,30
61250,15,75,104,5,169,20,11,384,62
17670,8,86,209,8,47,13,8,371,270
119689,30,50,66,0,70,3,7,196,230
49911,14,95,90,6,87,7,6,291,52
45627,13,43,9,0,10,0,2,64,32
1298,2,64,85,6,64,16,13,248,129
27118,9,19,89,4,275,18,6,411,281
122692,30,90,97,14,54,0,13,268,216
79126,18,35,7,1,36,0,6,85,114
82407,19,149,79,4,42,3,11,288,124
47444,13,75,146,10,158,21,9,419,36
51802,14,123,139,7,58,15,6,348,39
1516,2,96,52,2,96,3,8,257,129
92910,21,106,141,4,93,7,12,363,162
80420,18,80,10,1,67,0,5,163,116
118620,30,46,127,0,63,6,5,247,227
89209,20,42,46,1,257,8,14,368,147
45890,13,69,116,36,107,17,11,356,33
24903,9,51,130,5,163,24,5,378,277
9466,5,47,11,0,13,0,2,73,250
5945,4,64,105,1,105,3,13,291,243
19567,8,60,152,2,40,8,7,269,273
112972,28,67,61,0,24,0,2,154,201
20697,9,36,118,0,236,24,6,420,294
45509,13,118,40,0,194,0,9,361,32
91617,21,45,161,2,92,4,2,306,159
103985,25,60,71,2,89,3,3,228,181
18171,8,43,91,6,105,11,8,264,271
55328,14,80,136,1,75,3,6,301,47
4078,2,51,157,4,61,9,10,292,135
10531,7,77,19,2,193,5,28,324,253
108811,26,47,139,2,87,9,8,292,191
111823,28,8,69,1,25,2,2,107,199
64568,15,43,330,0,58,9,6,446,71
35145,11,91,224,1,31,10,13,370,15
98310,23,133,18,1,205,0,5,362,169
11651,7,74,86,4,108,7,20,299,259
2774,2,74,122,4,80,9,7,296,132
83638,19,118,108,9,51,14,18,318,127
117634,30,73,67,0,63,1,28,232,223
65558,15,70,85,6,198,18,11,388,74
108927,26,47,102,2,129,3,12,295,191
62309,15,65,124,10,172,16,11,398,64
2684,2,76,81,3,47,16,5,228,132
54653,14,137,111,12,110,7,12,389,46
6183,4,87,47,4,116,2,29,285,243
15228,8,85,92,5,78,14,7,281,265
91703,21,70,163,0,124,19,12,388,159
28267,9,21,51,3,246,12,4,337,284
124712,30,149,80,0,16,1,17,263,221
66033,15,81,242,3,121,17,7,471,75
46445,13,66,49,2,137,11,12,277,34
34227,11,7,62,0,20,3,0,92,8
93834,21,48,134,5,68,9,4,268,150
60293,15,82,62,6,195,18,18,381,59
3837,2,55,215,1,91,15,2,379,134
91760,21,78,169,1,155,26,5,434,159
58573,15,63,234,3,198,21,9,528,94
72529,16,32,57,1,43,0,8,141,102
125300,30,102,11,0,45,2,5,165,222
4509,2,54,104,4,47,7,8,224,136
53865,14,63,116,0,98,0,13,290,44
43590,12,84,6,4,116,3,9,222,28
101897,24,135,36,1,118,2,43,335,177
25531,9,27,62,3,287,14,4,397,278
51168,14,95,174,8,80,15,15,387,55
34003,10,59,180,0,29,3,6,277,7
49881,14,87,171,6,62,4,7,337,52
58953,15,91,101,9,186,23,8,418,95
112693,28,65,124,1,78,1,14,283,200
77847,17,36,88,9,174,32,11,350,111
519,1,138,124,5,106,25,16,414,2
118740,30,76,190,4,76,2,6,354,227
24289,9,30,90,6,217,12,19,374,275
92046,21,32,122,3,109,15,10,291,160
68320,15,60,37,2,227,21,16,363,82
61756,15,42,262,1,102,13,3,423,63
113468,28,83,98,5,81,11,15,293,202
127713,31,92,202,2,60,11,10,377,236
99481,24,215,61,1,94,1,26,398,171
105699,25,65,139,2,127,15,11,359,184
57460,15,58,70,4,80,7,8,227,90
99417,24,96,41,0,31,3,17,188,171
50467,14,119,171,16,56,13,8,383,54
9482,6,88,155,0,67,12,6,328,251
3294,2,45,76,4,50,15,7,197,133
77943,17,44,131,6,171,24,10,386,111
65160,15,65,65,3,158,13,3,307,73
23942,9,58,157,2,226,19,9,471,275
15162,8,95,103,6,59,10,1,274,265
82505,19,39,342,0,45,7,3,436,125
52883,14,72,185,4,58,18,10,347,42
69371,15,30,61,4,124,5,2,226,85
51838,14,92,184,5,58,9,9,357,39
118472,30,45,133,0,65,8,13,264,227
63639,15,57,126,3,192,19,9,406,67
74249,16,41,101,9,193,0,12,356,105
85961,20,132,23,0,140,4,39,338,140
108962,26,52,152,3,126,9,9,351,191
107328,26,46,236,4,60,7,3,356,188
83932,19,116,134,2,23,2,7,284,128
83710,19,161,86,2,89,6,21,365,128
118181,30,88,116,7,127,7,12,357,226
127965,31,222,93,0,32,1,12,360,236
72977,16,56,160,0,60,5,6,287,103
66320,15,68,236,1,112,16,19,452,76
73624,16,57,53,1,109,6,6,232,104
118125,30,64,63,1,112,5,0,245,226
125887,30,38,60,0,165,1,8,272,225
2884,2,49,72,7,51,2,3,184,132
113111,28,58,80,0,100,11,24,273,201
29355,9,36,62,1,282,8,1,390,287
58113,15,51,120,4,167,24,11,377,93
42110,12,53,30,2,152,8,10,255,25
43282,12,78,35,0,143,3,6,265,27
39479,11,23,79,0,14,0,4,120,11
118642,30,42,174,2,64,10,6,298,227
28477,9,31,39,1,297,9,15,392,284
29893,9,26,48,2,351,20,11,458,289
15635,8,118,288,2,249,17,10,684,266
32976,10,118,220,2,101,10,7,458,5
58704,15,51,115,2,162,15,12,357,94
91174,21,44,72,2,103,1,6,228,158
101725,24,43,118,1,40,1,27,230,177
32989,10,56,155,3,78,0,6,298,5
48610,14,105,236,6,32,11,14,404,49
78464,17,87,68,11,130,9,9,314,112
130530,32,73,125,2,134,12,16,362,241
89203,20,56,64,7,318,7,7,459,147
27960,9,49,58,2,328,16,12,465,283
60297,15,35,87,1,195,16,6,340,59
70066,15,60,4,0,95,0,5,164,86
57811,15,94,148,3,207,12,18,482,92
83522,19,68,182,4,70,20,6,350,127
45642,13,88,47,2,102,2,9,250,32
3864,2,43,161,2,68,13,2,289,134
80309,18,88,75,0,74,1,5,243,116
58038,15,44,147,4,185,25,10,415,93
125018,30,88,140,0,87,9,12,336,222
76840,16,18,18,0,25,2,1,64,100
31009,9,30,43,0,259,0,13,345,291
103482,25,28,46,0,10,1,4,89,180
57816,15,89,130,4,172,18,5,418,92
58670,15,38,104,2,183,13,9,349,94
21033,9,40,79,3,247,12,12,393,294
68886,15,61,81,7,162,15,18,344,83
86166,20,137,90,0,89,0,5,321,140
78502,17,61,109,37,139,23,18,387,112
89669,20,94,8,0,69,2,13,186,139
99432,24,25,66,10,6,0,19,126,171
45770,13,14,12,0,14,0,0,40,32
12856,7,57,47,1,165,8,10,288,262
116355,29,80,110,3,165,7,19,384,208
103332,25,38,61,6,94,3,11,213,180
56766,15,71,170,12,133,28,19,433,79
8060,5,99,132,6,49,10,12,308,247
26706,9,70,184,3,222,23,13,515,280
110353,27,142,5,0,252,1,6,406,195
84876,19,137,82,9,64,11,9,312,119
22641,9,15,94,3,232,11,8,363,298
77733,17,72,67,2,157,7,11,316,110
66573,15,94,144,9,95,10,28,380,76
79421,18,71,33,1,87,2,9,203,114
118032,30,40,58,1,172,9,24,304,226
110101,27,162,3,1,170,0,14,350,194
71142,15,52,89,5,195,18,8,367,89
35911,11,21,290,2,44,4,0,361,17
96272,22,105,187,3,57,3,13,368,164
25195,9,42,95,1,211,7,9,365,277
71544,15,105,97,5,80,1,10,298,91
18248,8,87,49,1,54,2,0,193,271
5825,4,163,43,173,37,3,31,450,242
123990,30,40,153,2,168,10,2,375,219
57016,15,65,78,4,170,4,13,334,79
45331,13,75,5,3,46,0,6,135,32
16700,8,86,83,5,35,5,1,215,268
124658,30,135,117,3,52,6,8,321,221
19035,8,73,163,3,32,11,19,301,272
10592,7,149,5,3,95,0,24,276,253
90015,21,130,64,1,24,2,17,238,148
50284,14,44,359,3,36,0,0,442,53
88461,20,98,134,3,202,9,6,452,146
10271,7,205,4,0,245,0,7,461,253
63784,15,43,82,3,256,16,7,407,69
84358,19,37,329,1,38,8,4,417,118
121023,30,62,80,1,145,16,10,314,213
56141,15,64,55,0,26,2,4,151,57
95474,21,90,136,3,138,8,11,386,154
81785,19,33,269,1,30,11,1,345,123
47352,13,60,129,6,192,20,7,414,36
118334,30,70,91,1,53,2,19,236,226
57417,15,131,82,11,125,21,12,382,90
38799,11,105,82,1,44,6,14,252,10
14427,7,100,44,0,208,5,8,365,255
16502,8,63,76,4,33,7,9,192,268
89778,20,111,38,0,198,8,12,367,139
118430,30,72,185,2,70,11,5,345,227
82710,19,67,93,5,124,12,17,318,125
2417,2,74,34,1,24,2,3,138,131
19389,8,132,48,16,34,4,7,241,273
121626,30,54,59,0,206,11,8,338,214
90679,21,128,67,0,44,0,6,245,156
35391,11,91,169,0,19,4,12,295,15
74803,16,44,29,2,83,4,5,167,106
53303,14,68,190,7,67,27,7,366,42
42298,12,58,37,1,151,4,8,259,25
60574,15,57,74,14,215,19,13,392,60
119195,30,155,94,0,182,3,15,449,229
112813,28,54,122,0,58,9,14,257,200
6278,4,100,85,13,160,1,20,379,243
122185,30,51,134,1,78,12,10,286,215
128172,31,175,121,3,50,5,5,359,237
120511,30,68,112,2,138,13,9,342,232
14155,7,52,60,0,123,1,4,240,254
489,1,77,203,5,91,10,9,395,2
36639,11,50,184,1,28,8,10,281,18
2792,2,38,61,5,36,8,4,152,132
66029,15,64,244,7,89,16,15,435,75
116098,29,70,101,2,141,8,19,341,207
115444,28,77,204,1,56,11,24,373,206
55943,14,90,99,20,174,20,12,415,48
36883,11,18,304,0,14,2,8,346,19
17278,8,26,23,0,12,0,0,61,269
3022,2,63,225,2,71,19,4,384,133
77597,17,35,127,2,201,14,14,393,110
66645,15,90,132,1,182,9,17,431,77
126379,31,83,302,1,43,2,10,441,233
122551,30,53,102,1,55,2,5,218,216
64823,15,97,111,3,134,15,15,375,72
35567,11,80,165,3,35,25,25,333,16
29190,9,35,79,1,295,24,10,444,287
24028,9,21,61,1,162,7,14,266,275
76418,16,42,83,1,100,8,10,244,99
75276,16,80,57,3,263,8,10,421,108
37983,11,68,273,3,55,27,11,437,21
90396,21,74,42,0,38,0,9,163,148
116303,29,56,148,3,172,16,9,404,208
20807,9,36,111,0,143,22,1,313,294
64563,15,33,254,0,58,9,0,354,71
33226,10,33,20,0,12,0,0,65,6
83556,19,130,58,7,30,8,14,247,127
42999,12,175,34,1,132,3,10,355,27
32518,10,79,25,0,1,0,3,108,4
69068,15,71,135,4,87,13,13,323,84
59054,15,49,218,1,208,26,10,512,95
122376,30,113,107,9,132,6,14,381,216
124627,30,46,93,2,169,7,7,324,221
34711,11,29,166,4,55,1,12,267,14
40067,11,34,53,3,77,3,3,173,13
64904,15,233,40,2,86,1,8,370,72
95065,21,58,51,6,76,4,8,203,153
61161,15,4,60,0,37,3,1,105,62
15674,8,38,54,2,39,2,3,138,266
99701,24,51,192,4,87,24,8,366,172
67735,15,45,48,2,206,16,17,334,80
34810,11,54,252,2,15,0,35,358,14
103325,25,95,132,1,181,7,7,423,180
124788,30,15,4,3,242,0,4,268,221
75851,16,41,212,1,71,6,1,332,98
46331,13,43,101,10,148,6,10,318,34
34389,11,35,98,1,16,6,5,161,8
80636,19,88,152,13,61,15,13,342,117
127680,31,118,178,1,78,14,16,405,236
23490,9,36,124,2,218,12,13,405,300
63413,15,56,212,2,162,27,8,467,67
50407,14,103,110,8,52,19,7,299,53
110739,27,103,23,0,132,3,11,272,196
3478,2,39,86,4,40,9,3,181,134
50693,14,107,227,3,109,28,10,484,54
12048,7,88,71,0,140,14,10,323,260
6807,5,99,72,3,57,7,10,248,245
113299,28,73,157,3,79,1,14,327,201
116969,29,42,103,1,124,8,3,281,209
1524,2,57,89,4,62,3,9,224,129
66313,15,58,262,5,151,24,9,509,76
43165,12,76,40,1,71,5,15,208,27
45306,13,68,24,3,137,1,7,240,32
40806,12,7,5,0,45,0,1,58,22
120068,30,119,133,3,116,10,17,398,231
20204,9,34,137,1,216,17,11,416,285
54645,14,124,167,5,133,13,20,462,46
117233,30,48,123,5,96,2,11,285,212
21301,9,21,68,4,255,21,7,376,295
3908,2,41,88,5,58,6,4,202,134
98541,23,89,45,17,93,5,11,260,169
24589,9,35,114,1,205,13,6,374,276
104564,25,59,84,1,87,8,6,245,182
43623,12,74,48,4,138,12,14,290,28
100296,24,41,67,0,5,1,9,123,173
90377,21,56,84,4,152,4,15,315,148
124137,30,58,58,1,69,9,11,206,220
100550,24,112,152,4,135,8,2,413,174
38721,11,81,171,4,81,10,7,354,10
95945,21,106,25,0,46,0,12,189,155
109962,27,99,9,2,232,0,6,348,194
28071,9,24,88,2,267,11,7,399,283
116580,29,66,114,2,174,10,8,374,208
55834,14,58,112,2,94,3,19,288,48
118621,30,53,194,1,112,19,5,384,227
71650,16,44,12,0,154,0,10,220,97
97461,22,72,104,2,84,2,22,286,167
95525,21,50,184,2,89,15,6,346,154
10469,7,182,18,0,236,0,13,449,253
5275,3,15,7,2,22,0,3,49,211
129854,32,12,1,0,27,0,1,41,240
106329,25,102,100,4,117,16,26,365,185
52322,14,130,187,5,82,13,10,427,40
23095,9,25,124,1,161,16,3,330,299
90834,21,150,28,4,50,0,9,241,157
63076,15,84,100,6,129,15,8,342,66
45914,13,89,61,6,90,8,8,262,33
70157,15,91,109,3,143,12,10,368,87
70388,15,64,103,4,222,26,17,436,87
60383,15,36,97,4,249,19,11,416,60
40653,12,19,5,0,42,0,1,67,22
33924,10,41,196,2,51,6,6,302,7
35813,11,42,125,1,69,4,12,253,16
69524,15,175,74,0,67,4,11,331,85
30411,9,28,143,5,209,18,4,407,290
52505,14,156,119,7,56,8,21,367,41
68515,15,84,71,10,193,24,25,407,83
76274,16,42,87,4,135,12,11,291,99
77076,17,28,155,1,107,9,5,305,109
63543,15,35,172,4,113,11,4,339,67
91521,21,62,87,24,96,6,34,309,158
120258,30,74,121,3,239,17,8,462,231
107452,26,66,168,3,45,9,8,299,188
57534,15,149,89,3,204,18,11,474,92
95842,21,57,52,0,41,0,9,159,155
107280,26,71,188,11,61,1,2,334,187
74018,16,34,182,4,96,5,23,344,105
50798,14,58,185,4,52,5,10,314,55
76592,16,73,55,3,128,3,7,269,100
85079,19,91,96,3,70,4,13,277,120
4585,2,90,87,3,90,13,3,286,136
101946,24,63,97,2,103,18,8,291,177
28976,9,25,171,1,166,5,3,371,286
47179,13,53,135,8,111,21,4,332,36
50447,14,134,111,9,61,11,2,328,54
93549,21,37,115,8,153,10,9,332,149
39195,11,79,283,3,61,22,10,458,11
7476,5,76,205,0,88,9,5,383,246
33548,10,92,110,6,106,0,7,321,6
112324,28,100,129,3,79,0,14,325,199
111951,28,142,100,2,69,10,5,328,199
127555,31,84,230,1,86,15,8,424,236
129517,32,50,64,3,62,4,2,185,239
122301,30,94,115,2,91,7,13,322,216
119048,30,105,140,5,108,3,12,373,228
25769,9,42,71,1,243,17,14,388,278
77415,17,49,153,4,160,6,18,390,109
116396,29,69,104,2,148,11,8,342,208
32599,10,74,198,2,101,14,6,395,5
48141,14,73,103,1,50,3,7,237,38
103580,25,50,53,1,31,3,2,140,180
17285,8,53,205,19,70,12,5,364,269
98641,23,48,115,0,136,11,7,317,170
1399,2,72,98,3,42,4,18,237,129
5759,4,89,100,42,111,9,0,351,242
16219,8,55,225,2,54,13,5,354,267
84098,19,101,134,6,70,31,14,356,128
38312,11,16,104,0,47,1,4,172,9
73581,16,13,29,1,73,0,6,122,104
98394,23,125,135,5,108,15,8,396,169
87337,20,161,58,3,194,3,6,425,143
127758,31,62,184,2,56,4,10,318,236
27506,9,29,85,3,312,17,14,460,282
13360,7,93,23,0,89,3,28,236,263
37157,11,50,165,4,59,11,16,305,19
98668,23,38,81,2,108,6,5,240,170
109552,27,101,13,0,104,1,11,230,193
33805,10,105,135,2,81,0,27,350,7
103142,25,73,74,1,81,8,0,237,179
16879,8,119,186,12,78,9,10,414,269
54576,14,100,135,4,59,11,13,322,45
14801,7,81,130,4,173,18,8,414,256
75278,16,93,80,2,133,7,5,320,108
84516,19,59,312,1,61,4,1,438,118
53166,14,90,134,3,47,21,12,307,42
78526,17,55,86,2,170,10,12,335,112
102213,25,66,61,1,9,0,1,138,178
117709,30,77,100,3,63,2,15,260,223
31422,9,39,175,1,124,10,2,351,292
104483,25,55,146,2,130,11,6,350,182
43924,12,60,22,13,119,5,9,228,28
35544,11,29,66,2,30,6,1,134,16
107608,26,69,269,2,95,14,2,451,188
65648,15,60,61,3,186,10,9,329,74
89646,20,127,32,7,199,5,8,378,139
103347,25,143,23,0,97,0,7,270,180
10083,6,55,124,1,83,5,3,271,252
77655,17,38,180,3,187,12,2,422,110
77389,17,81,140,2,173,18,6,420,109
121180,30,73,89,2,158,16,9,347,213
41415,12,7,3,0,79,1,0,90,23
54426,14,96,187,12,54,11,13,373,45
124683,30,72,100,2,84,7,9,274,221
73409,16,68,91,2,96,5,3,265,104
25529,9,116,185,1,383,23,11,719,278
87589,20,46,4,0,50,0,6,106,144
32427,10,5,28,0,14,0,3,50,4
81563,19,66,242,6,60,10,0,384,122
83868,19,131,58,1,50,54,34,328,128
45698,13,48,40,5,60,1,16,170,32
117515,30,48,92,0,127,4,11,282,223
94480,21,81,117,3,125,21,7,354,151
85628,20,57,72,1,141,13,10,294,137
25381,9,40,80,2,246,6,6,380,278
55266,14,51,104,1,132,4,7,299,47
32705,10,69,131,1,85,8,8,302,5
130010,32,83,19,1,113,0,7,223,240
67369,15,27,62,3,195,19,12,318,80
22050,9,29,58,2,188,7,8,292,297
88872,20,163,70,2,27,7,23,292,147
4295,2,50,139,6,74,11,10,290,135
84192,19,56,205,3,45,5,12,326,128
37590,11,36,117,0,31,1,8,193,20
18620,8,26,9,1,12,0,0,48,271
39794,11,32,97,4,83,4,14,234,12
42253,12,61,116,0,163,16,7,363,25
119547,30,66,112,0,88,2,8,276,229
127890,31,63,177,2,58,9,14,323,236
43087,12,24,0,2,46,0,0,72,27
48146,14,200,132,1,10,3,6,352,38
88640,20,64,72,1,138,10,7,292,146
123245,30,83,27,5,33,2,12,162,218
37154,11,48,187,1,51,5,11,303,19
73953,16,54,137,3,84,2,13,293,105
30148,9,15,43,2,286,4,12,362,289
117743,30,79,10,3,63,1,14,170,223
80999,19,106,193,11,71,12,5,398,121
48304,14,111,98,2,153,8,15,387,38
4482,2,79,139,4,81,6,1,310,136
20665,9,34,87,0,295,17,9,442,294
28363,9,23,93,2,309,16,9,452,284
64104,15,112,139,1,170,12,6,440,70
22066,9,50,101,0,203,12,8,374,297
88834,20,64,106,1,244,22,15,452,146
69093,15,75,243,2,91,11,21,443,84
41495,12,46,7,0,40,2,6,101,23
32357,10,7,44,0,8,0,2,61,4
74207,16,37,83,3,98,7,10,238,105
48736,14,23,94,0,4,2,4,127,49
85104,19,139,143,6,135,8,7,438,120
52983,14,71,114,1,61,15,6,268,42
53438,14,76,219,3,92,15,8,413,43
65745,15,78,68,3,194,20,11,374,74
78591,17,39,122,5,184,3,7,360,112
77443,17,54,55,2,101,5,5,222,109
94998,21,61,96,4,162,4,9,336,153
128024,31,175,314,0,38,0,4,531,237
42890,12,73,11,0,59,1,5,149,26
49176,14,118,223,1,72,14,0,428,50
7159,5,56,87,1,47,7,3,201,245
81625,19,39,273,7,29,15,3,366,122
94846,21,58,174,0,39,1,17,289,152
59510,15,73,85,1,179,18,11,367,58
72692,16,81,38,0,118,3,4,244,102
91789,21,141,74,4,169,15,6,409,159
93285,21,58,162,2,117,13,5,357,163
46817,13,66,116,3,143,12,5,345,35
100388,24,114,116,0,2,0,7,239,173
10783,7,12,52,0,4,1,6,75,257
123297,30,33,91,0,140,12,4,280,218
45463,13,130,28,3,147,5,4,317,32
56831,15,113,98,4,103,3,22,343,79
114742,28,59,146,0,63,5,10,283,204
62088,15,70,69,6,231,16,15,407,64
45108,13,104,96,6,69,2,18,295,31
129708,32,63,108,8,169,11,20,379,240
31468,9,31,134,1,172,9,2,349,292
5575,4,79,115,6,148,17,7,372,242
58255,15,67,65,1,250,30,6,419,93
49790,14,75,162,4,68,12,3,324,52
1479,2,29,80,5,25,3,5,147,129
100955,24,35,149,3,53,5,5,250,175
120336,30,89,110,4,76,3,12,294,231
114395,28,126,74,1,41,0,6,248,203
111475,27,121,13,0,162,3,4,303,198
76897,16,52,191,2,70,10,13,338,100
52821,14,156,90,9,47,3,13,318,41
31185,9,40,80,0,301,17,6,444,292
90514,21,111,129,2,66,0,12,320,156
129005,32,51,60,1,43,2,6,163,239
9699,6,102,134,2,39,3,6,286,251
29965,9,38,77,2,348,11,14,490,289
125656,30,45,96,2,25,1,14,183,224
13436,7,92,51,2,116,1,17,279,264
108996,26,97,144,3,66,0,10,320,192
30869,9,34,36,1,287,15,12,385,291
89791,20,135,27,1,195,1,8,367,139
113882,28,104,97,1,65,4,12,283,202
107226,26,119,115,0,100,7,0,341,187
104951,25,69,14,2,6,1,3,95,183
90340,21,63,142,3,76,7,7,298,148
74849,16,30,183,1,139,12,10,375,107
42319,12,57,23,2,131,2,14,229,25
118223,30,70,115,4,122,5,13,329,226
92158,21,78,146,3,126,14,13,380,160
86399,20,58,22,6,155,5,21,267,141
58009,15,74,149,0,170,21,7,421,93
74988,16,28,184,0,114,13,1,340,107
111072,27,216,18,0,207,0,9,450,197
127286,31,118,163,1,70,13,15,380,235
39998,11,6,49,0,42,1,7,105,13
66609,15,155,86,1,144,2,15,403,77
27729,9,25,127,2,157,9,5,325,283
74662,16,14,32,0,61,2,2,111,106
97092,22,40,142,1,80,12,6,281,166
6129,4,23,29,2,45,1,2,102,243
70479,15,46,81,4,187,12,3,333,87
17550,8,58,147,3,42,3,3,256,270
71202,15,58,25,1,209,6,10,309,89
53795,14,73,134,2,21,6,9,245,44
60473,15,58,92,4,255,14,12,435,60
56251,15,89,20,4,141,1,9,264,57
101021,24,51,166,1,74,17,10,319,175
56838,15,134,90,6,66,5,16,317,79
128429,32,42,64,4,97,1,22,230,238
5463,4,63,122,4,122,12,4,327,242
21129,9,36,139,5,260,29,6,475,295
11599,7,125,46,2,125,5,12,315,259
78640,17,92,78,2,226,24,9,431,112
86914,20,34,12,3,140,2,14,205,142
125833,30,97,73,2,234,7,2,415,225
479,1,105,102,2,87,8,13,317,2
4745,2,62,111,8,74,3,10,268,136
40913,12,65,20,1,104,1,6,197,22
70817,15,68,72,5,154,12,9,320,88
34250,11,224,81,3,12,1,9,330,8
44390,12,24,14,3,132,2,5,180,29
64377,15,78,92,5,198,12,11,396,70
14415,7,188,18,1,195,2,9,413,255
2551,2,55,176,4,57,10,6,308,132
94192,21,45,216,3,106,11,2,383,151
89063,20,105,76,1,253,3,11,449,147
9996,6,82,156,0,107,7,17,369,252
29258,9,19,66,3,245,19,8,360,287
91007,21,81,170,4,86,17,7,365,157
66342,15,53,181,4,97,8,10,353,76
109598,27,134,16,0,261,1,9,421,193
4472,2,39,76,5,57,8,5,190,136
74176,16,50,30,1,151,1,16,249,105
15685,8,48,53,4,46,6,4,161,266
45812,13,67,61,8,125,20,9,290,33
80098,18,89,67,1,148,3,9,317,116
97569,22,46,316,3,84,12,9,470,167
43270,12,139,17,1,188,2,1,348,27
63970,15,60,44,2,205,11,0,322,69
8893,5,61,226,3,132,16,6,444,249
127969,31,185,185,3,31,4,19,427,236
9548,6,95,186,2,80,16,1,380,251
119302,30,51,116,3,141,2,10,323,229
59616,15,36,119,5,149,12,2,323,58
100320,24,97,90,0,10,1,12,210,173
43563,12,72,29,4,129,1,11,246,28
102185,25,21,26,1,22,0,3,73,178
45822,13,86,135,10,144,26,5,406,33
13705,7,67,130,3,159,15,7,381,264
125702,30,140,85,0,78,0,10,313,224
123527,30,67,206,4,143,10,10,440,218
86179,20,159,45,2,65,1,19,291,140
18713,8,69,82,3,17,7,10,188,272
90152,21,59,54,2,81,3,16,215,148
11029,7,119,23,1,150,2,15,310,258
125835,30,74,42,2,184,3,3,308,225
51104,14,97,270,1,103,17,12,500,55
96555,22,93,110,13,84,1,30,331,165
9073,5,36,108,3,70,10,2,229,249
94477,21,67,155,10,100,19,6,357,151
108087,26,70,72,1,117,6,22,288,189
81699,19,102,116,2,42,12,11,285,123
57392,15,44,76,4,127,11,9,271,90
103899,25,52,77,4,120,4,7,264,181
40325,11,47,130,8,92,6,16,299,13
67166,15,47,70,1,166,14,7,305,78
64264,15,62,113,3,136,18,12,344,70
81879,19,95,163,4,47,8,12,329,123
94450,21,70,178,4,96,23,2,373,151
52847,14,82,240,2,45,14,10,393,41
88733,20,75,76,2,247,13,15,428,146
23462,9,35,144,3,256,22,5,465,300
89352,20,184,11,4,133,2,26,360,138
95496,21,71,167,3,98,12,12,363,154
38829,11,48,57,1,76,2,1,185,10
99713,24,30,136,2,86,12,13,279,172
31386,9,21,32,6,320,11,8,398,292
46552,13,48,98,2,109,15,8,280,34
35616,11,96,80,2,44,11,19,252,16
22554,9,35,81,1,328,13,12,470,298
36472,11,65,386,1,60,8,6,526,18
35409,11,83,202,0,37,7,24,353,15
24207,9,47,140,0,248,8,3,446,275
50260,14,64,309,1,46,12,2,434,53
33488,10,30,63,1,3,0,2,99,6
24560,9,49,106,0,215,18,9,397,276
20022,9,28,72,4,277,11,5,397,274
77420,17,34,138,3,101,6,7,289,109
79898,18,28,3,0,23,0,3,57,115
66418,15,65,228,5,123,11,6,438,76
9780,6,87,176,0,105,11,1,380,251
6226,4,98,172,5,96,7,13,391,243
23350,9,52,130,4,291,15,12,504,299
29891,9,16,43,0,305,15,9,388,289
50326,14,153,192,6,57,12,12,432,53
81341,19,97,128,4,32,16,9,286,122
79558,18,98,44,3,126,19,9,299,115
118120,30,119,62,1,158,2,13,355,226
2649,2,55,102,4,40,4,3,208,132
63569,15,54,124,2,161,25,5,371,67
79993,18,62,103,1,34,1,1,202,116
94518,21,61,333,0,123,14,5,536,151
19740,8,9,11,0,3,0,0,23,273
120451,30,134,125,1,88,3,9,360,231
123820,30,48,244,0,123,9,6,430,219
119681,30,41,90,1,104,7,13,256,230
42077,12,33,39,1,158,3,7,241,25
2155,2,38,106,1,94,10,4,253,131
97566,22,66,139,3,58,7,12,285,167
67262,15,36,68,0,170,17,4,295,78
129106,32,43,76,5,86,6,7,223,239
90808,21,96,121,1,95,4,30,347,157
87953,20,107,97,4,517,14,15,754,144
77612,17,39,151,2,189,17,13,411,110
92598,21,46,120,6,123,12,12,319,161
5617,4,84,172,5,166,14,11,452,242
58408,15,87,85,8,157,17,6,360,94
112982,28,72,71,0,46,1,14,204,201
29849,9,25,79,1,275,16,3,399,289
121046,30,70,100,2,141,7,5,325,213
97965,23,66,125,2,158,10,13,374,168
93396,21,86,167,10,147,24,10,444,163
36058,11,53,354,3,18,11,9,448,17
88433,20,78,61,1,244,14,6,404,146
104084,25,41,33,5,144,4,5,232,181
85718,20,62,132,0,153,6,13,366,137
128730,32,22,26,1,58,1,3,111,238
69897,15,89,37,0,114,0,24,264,86
50329,14,43,281,0,54,12,4,394,53
100784,24,40,131,0,151,2,13,337,174
63325,15,63,163,3,167,15,6,417,67
4256,2,68,126,9,78,13,4,298,135
127726,31,86,125,1,40,10,12,274,236
26539,9,51,191,5,264,25,9,545,280
25073,9,46,71,2,143,7,6,275,277
2731,2,68,146,5,91,12,3,325,132
67685,15,39,68,5,169,16,6,303,80
20121,9,22,22,2,186,6,9,247,274
48130,14,87,117,0,22,6,5,237,38
83646,19,144,114,6,49,6,14,333,127
61625,15,39,359,0,93,12,6,509,63
97373,22,39,239,4,75,7,4,368,166
92164,21,80,136,4,77,10,8,315,160
104068,25,44,75,1,59,5,13,197,181
46375,13,63,41,6,90,5,11,216,34
29296,9,29,52,3,349,10,11,454,287
77646,17,53,166,6,203,12,11,451,110
50475,14,134,144,2,67,8,5,360,54
95228,21,59,38,7,176,0,3,283,153
99154,24,71,163,1,39,5,8,287,171
55773,14,133,170,0,89,10,2,404,48
27389,9,31,193,1,130,14,4,373,282
114287,28,84,128,10,101,4,8,335,203
122516,30,97,85,0,179,5,10,376,216
29238,9,37,50,4,311,13,12,427,287
125205,30,61,107,1,114,9,3,295,222
45396,13,72,144,5,135,8,9,373,32
130381,32,63,89,1,87,14,15,269,241
119783,30,57,127,2,57,7,11,261,230
60105,15,38,132,4,166,10,3,353,59
112822,28,60,168,4,56,4,8,300,200
92512,21,45,88,0,153,5,4,295,161
73069,16,48,84,0,109,6,3,250,103
92678,21,88,131,8,119,14,14,374,162
22074,9,36,73,1,279,16,10,415,297
97324,22,82,120,1,77,13,15,308,166
31917,9,15,42,3,332,10,7,409,293
76513,16,5,27,1,121,2,1,157,99
49807,14,102,201,5,73,19,6,406,52
97524,22,113,117,1,117,11,8,367,167
15530,8,92,74,4,40,9,12,231,266
52555,14,149,161,8,83,13,22,436,41
64908,15,64,13,3,132,3,10,225,72
108706,26,34,104,0,138,11,11,298,191
86182,20,103,11,0,177,0,6,297,140
101493,24,52,238,4,110,21,14,439,176
36025,11,29,326,4,30,6,10,405,17
41477,12,8,1,0,42,0,0,51,23
103152,25,71,60,1,71,4,7,214,179
101345,24,42,182,4,78,15,6,327,176
28560,9,35,96,4,180,12,7,334,286
39845,11,13,81,5,124,0,10,233,12
49570,14,96,120,6,65,12,9,308,51
113665,28,46,77,1,56,3,6,189,202
61608,15,44,278,3,96,19,3,443,63
7452,5,92,73,1,95,6,11,278,246
40677,12,18,24,2,125,0,7,176,22
79481,18,57,15,0,44,1,2,119,114
57335,15,94,140,7,198,28,12,479,90
97511,22,68,89,0,66,7,15,245,167
119881,30,31,92,0,83,1,8,215,230
268,1,77,148,13,102,19,8,367,1
82127,19,100,132,7,43,14,16,312,123
90488,21,112,81,4,106,8,24,335,156
69301,15,90,234,5,94,17,12,452,84
66202,15,85,145,5,72,9,20,336,75
75950,16,39,188,0,124,7,6,364,98
108584,26,34,223,2,73,10,1,343,191
111255,27,146,2,0,242,1,6,397,197
71540,15,41,110,0,62,4,14,231,91
24333,9,33,134,1,220,7,8,403,275
101253,24,26,146,1,39,3,3,218,175
42380,12,62,54,10,144,9,9,288,25
74775,16,64,53,2,121,3,10,253,106
106095,25,26,114,1,104,6,14,265,185
59221,15,110,156,3,81,11,17,378,96
25875,9,25,77,1,255,14,13,385,279
57009,15,128,158,1,125,2,13,427,79
63520,15,48,124,1,169,23,9,374,67
127387,31,102,135,3,64,3,12,319,235
122996,30,109,72,2,210,7,10,410,217
125797,30,45,127,0,88,1,10,271,224
3216,2,68,134,4,44,14,1,265,133
114512,28,89,235,4,135,11,9,483,204
73637,16,53,131,1,40,1,1,227,104
46366,13,58,23,1,20,1,1,104,34
21320,9,27,71,1,251,12,7,369,295
74703,16,64,71,1,69,3,10,218,106
38210,11,71,150,2,77,14,7,321,9
22773,9,32,72,1,256,12,2,375,298
20020,9,18,40,1,195,8,14,276,274
91645,21,84,113,0,77,5,1,280,159
90604,21,62,125,2,69,6,10,274,156
11146,7,269,6,1,144,7,10,437,258
25956,9,37,89,0,287,10,8,431,279
84019,19,105,131,7,22,1,16,282,128
72389,16,7,14,1,80,0,0,102,101
18854,8,79,84,2,36,7,7,215,272
113371,28,81,189,5,61,5,15,356,201
12176,7,82,4,0,29,0,9,124,260
78877,17,79,51,11,139,10,9,299,113
40377,12,74,12,2,139,0,1,228,22
23614,9,45,119,2,306,11,8,491,300
116556,29,77,151,3,181,31,16,459,208
15152,8,90,53,6,48,8,7,212,265
101512,24,58,217,3,68,6,14,366,176
13190,7,86,12,1,95,0,13,207,263
79458,18,80,7,0,146,0,25,258,114
20809,9,38,120,2,170,14,9,353,294
93656,21,52,149,2,128,11,12,354,149
18853,8,85,129,3,55,7,14,293,272
116088,29,14,55,0,95,7,2,173,207
8578,5,341,300,15,169,15,38,878,248
95232,21,86,11,2,25,0,8,132,153
15889,8,103,63,5,62,4,3,240,266
105057,25,76,27,0,23,0,2,128,183
81710,19,42,249,6,59,12,5,373,123
49890,14,23,144,0,55,5,4,231,52
127144,31,99,145,5,48,7,2,306,235
25063,9,47,51,1,241,9,5,354,277
130779,32,35,32,1,86,2,1,157,241
118359,30,56,206,1,53,6,7,329,227
9252,5,129,110,6,55,18,16,334,250
83492,19,78,285,10,77,13,9,472,127
16265,8,51,84,0,53,4,1,193,267
941,1,73,182,1,116,22,8,402,3
98490,23,119,161,3,101,15,16,415,169
96679,22,142,143,0,96,7,7,395,165
38480,11,95,180,3,46,7,16,347,9
65465,15,87,121,2,181,10,11,412,73
109397,26,28,156,1,54,2,2,243,192
83066,19,17,40,1,9,1,3,71,126
91046,21,101,190,4,94,14,13,416,157
48336,14,17,28,0,17,0,3,65,38
75250,16,35,7,0,18,1,0,61,108
32186,10,52,47,0,4,0,1,104,4
27858,9,21,108,6,284,33,7,459,283
93689,21,29,207,4,124,13,5,382,149
5389,3,22,116,0,84,5,4,231,211
89309,20,29,21,4,107,1,10,172,138
94705,21,75,114,3,119,7,4,322,152
108392,26,45,204,1,39,14,8,311,190
65540,15,65,47,4,196,10,11,333,74
22777,9,47,50,2,207,7,5,318,298
106230,25,50,122,6,156,18,8,360,185
115086,28,69,149,6,56,5,31,316,205
106110,25,44,146,3,137,8,4,342,185
65730,15,70,72,6,270,17,6,441,74
25882,9,31,101,6,294,10,12,454,279
82861,19,59,260,5,41,4,5,374,126
115408,28,98,189,3,82,9,28,409,206
63671,15,53,140,4,178,33,7,415,69
88356,20,94,56,3,51,1,10,215,145
60547,15,46,64,4,248,10,11,383,60
101049,24,32,147,1,78,14,6,278,175
9332,5,82,233,5,77,23,7,427,250
51397,14,75,162,1,87,25,7,357,56
40596,12,53,13,1,93,3,2,165,22
28194,9,24,71,1,273,6,12,387,284
124527,30,78,117,1,90,2,7,295,220
99900,24,63,197,3,34,6,11,314,172
63045,15,105,128,6,151,22,7,419,66
70328,15,67,64,1,218,13,28,391,87
7045,5,139,56,1,62,7,13,278,245
116734,29,65,93,2,113,6,31,310,209
40980,12,47,2,0,23,1,0,73,23
51661,14,11,206,2,44,10,0,273,39
41662,12,33,3,2,78,0,3,119,24
37244,11,39,147,4,30,7,7,234,19
108602,26,40,120,1,95,9,8,273,191
117167,30,60,85,1,115,6,12,279,212
67774,15,41,76,1,250,14,8,390,81
44405,12,62,58,1,58,3,10,192,29
49694,14,61,79,3,12,6,10,171,52
82172,19,159,64,1,64,4,22,314,124
21107,9,31,157,2,197,6,6,399,294
79541,18,113,39,9,203,7,6,377,115
37276,11,61,166,0,120,42,10,399,20
20179,9,23,52,1,275,15,7,373,285
108011,26,55,96,0,154,12,2,319,189
71184,15,80,59,3,232,16,13,403,89
129414,32,58,24,0,78,1,4,165,239
36509,11,76,332,6,75,14,12,515,18
64183,15,75,134,2,140,9,6,366,70
105604,25,80,90,2,88,11,5,276,184
18435,8,64,82,1,24,4,12,187,271
46932,13,34,51,2,137,78,13,315,35
59892,15,26,46,3,151,8,10,244,58
50098,14,124,175,7,80,20,13,419,53
62673,15,46,102,2,208,25,6,389,65
24155,9,55,94,4,268,20,11,452,275
75627,16,89,44,3,196,3,11,346,108
58879,15,47,69,3,197,11,11,338,95
15652,8,86,123,4,34,7,4,258,266
114696,28,70,137,3,143,3,1,357,204
10346,7,141,199,1,158,0,13,512,253
36366,11,53,182,3,32,6,8,284,18
85637,20,50,38,0,137,1,13,239,137
126410,31,262,105,3,66,2,1,439,233
30884,9,25,235,2,155,16,11,444,291
58534,15,48,295,2,143,10,6,504,94
65483,15,52,78,2,154,9,9,304,73
119092,30,45,111,0,97,5,9,267,228
100072,24,20,92,20,69,19,19,239,173
122196,30,48,144,1,71,11,4,279,215
86932,20,85,21,1,128,4,10,249,142
33898,10,54,98,2,78,9,23,264,7
36467,11,39,305,2,30,9,8,393,18
104923,25,100,60,3,29,1,6,199,182
109313,26,53,110,4,131,5,8,311,192
4403,2,64,90,3,78,14,12,261,136
127029,31,117,116,2,79,2,7,323,234
114933,28,100,116,16,66,1,7,306,205
84166,19,93,180,4,71,3,5,356,128
114669,28,71,137,8,104,10,11,341,204
49597,14,72,241,2,29,1,5,350,52
31713,9,55,68,2,281,15,12,433,293
92799,21,148,82,1,135,5,11,382,162
23148,9,38,100,1,279,17,8,443,299
51724,14,88,192,8,64,20,19,391,39
75496,16,45,172,2,118,15,3,355,108
73942,16,75,35,1,167,4,15,297,105
25610,9,30,143,2,216,11,5,407,278
29523,9,24,51,2,239,11,1,328,288
106951,26,59,119,2,175,20,6,381,187
66331,15,101,315,1,113,24,3,557,76
7126,5,71,167,3,58,6,1,306,245
44322,12,85,3,0,88,1,3,180,29
28406,9,52,77,4,326,14,11,484,284
73806,16,59,210,2,85,7,9,372,104
102534,25,135,99,0,18,6,7,265,178
98170,23,69,99,2,131,8,9,318,168
33349,10,79,38,0,129,4,11,261,6
45665,13,45,27,1,152,1,7,233,32
13896,7,24,37,3,154,2,9,229,254
127073,31,83,290,0,51,8,13,445,235
57395,15,105,93,5,125,15,13,356,90
59884,15,33,79,4,141,11,1,269,58
101872,24,131,90,1,96,1,41,360,177
124982,30,183,97,1,65,1,0,347,222
69187,15,47,190,2,97,20,5,361,84
8706,5,61,197,4,99,10,4,375,249
60656,15,46,87,8,213,25,6,385,60
14840,7,73,96,1,183,11,14,378,256
76446,16,26,90,2,95,3,9,225,99
74672,16,34,152,1,56,6,4,253,106
13151,7,117,8,4,27,2,12,170,263
7731,5,25,13,0,10,1,1,50,246
51492,14,103,146,5,88,19,6,367,56
91957,21,72,182,3,145,20,17,439,160
53866,14,90,134,0,91,2,7,324,44
71476,15,93,160,4,99,12,20,388,91
35435,11,66,238,6,64,23,21,418,16
26363,9,37,136,0,206,20,6,405,280
16479,8,83,169,6,73,9,7,347,268
96331,22,141,268,0,62,0,11,482,164
101826,24,55,91,2,139,5,16,308,177
91214,21,117,80,2,63,1,11,274,158
85602,20,48,55,0,188,6,16,313,137
38057,11,60,226,4,53,14,12,369,21
92951,21,51,29,1,42,0,6,129,162
102665,25,42,86,0,56,3,8,195,178
25330,9,44,136,4,172,20,7,383,277
27486,9,17,66,2,248,48,8,389,282
17356,8,59,121,2,29,3,2,216,269
21318,9,31,71,2,270,21,11,406,295
106717,26,40,127,0,68,6,4,245,186
101274,24,53,189,2,60,17,8,329,176
807,1,108,227,2,79,18,4,438,3
84703,19,92,143,4,53,12,12,316,119
86643,20,109,44,2,164,5,5,329,141
70373,15,47,104,3,216,40,13,423,87
90669,21,63,119,2,105,7,28,324,156
108615,26,24,146,0,86,6,5,267,191
46991,13,116,81,5,148,12,8,370,35
105291,25,72,49,2,72,1,8,204,183
69268,15,63,207,4,89,13,19,395,84
38199,11,42,129,3,41,6,7,228,9
66933,15,21,26,2,11,4,1,65,77
56660,15,117,129,4,153,16,9,428,68
8612,5,46,163,4,61,9,4,287,248
84539,19,36,317,1,71,13,2,440,118
31687,9,36,96,1,296,20,5,454,293
3413,2,36,60,4,67,3,6,176,134
42081,12,35,36,1,183,3,11,269,25
88817,20,66,60,1,260,16,26,429,146
45302,13,179,32,8,129,7,10,365,32
9732,6,146,166,3,98,6,18,437,251
102638,25,55,135,0,25,0,3,218,178
18296,8,84,89,19,53,3,1,249,271
48930,14,124,269,1,36,13,10,453,50
107809,26,169,244,1,36,1,5,456,189
113369,28,81,165,2,52,11,12,323,201
90323,21,78,99,6,114,13,22,332,148
54745,14,102,164,11,35,10,6,328,46
11600,7,125,37,1,128,2,9,302,259
42865,12,59,22,4,167,6,7,265,26
130742,32,87,54,1,104,1,6,253,241
44598,12,1,31,5,46,131,23,237,30
14684,7,26,76,3,78,3,45,231,256
38191,11,92,226,3,65,6,7,399,9
79666,18,110,103,10,169,14,7,413,115
73924,16,116,97,9,92,11,13,338,105
80056,18,73,48,1,82,1,2,207,116
108263,26,28,197,2,43,2,13,285,190
101959,24,139,152,0,155,21,58,525,177
25223,9,35,51,1,199,11,0,297,277
29302,9,48,46,1,343,11,7,456,287
7583,5,58,123,0,50,0,2,233,246
52144,14,76,235,5,123,16,9,464,40
1153,1,94,203,4,99,16,10,426,3
28863,9,47,167,2,225,17,19,477,286
120105,30,41,152,4,41,6,6,250,231
78764,17,47,87,11,161,9,8,323,113
57713,15,58,44,1,221,11,5,340,92
2227,2,72,150,1,83,11,5,322,131
51097,14,85,165,8,77,8,15,358,55
102709,25,46,86,0,28,0,7,167,178
71523,15,106,216,0,64,7,19,412,91
123162,30,83,61,1,24,1,16,186,218
95479,21,71,108,0,88,10,3,280,154
57194,15,73,94,5,166,21,6,365,90
39347,11,35,159,1,49,6,13,263,11
27428,9,63,140,4,299,16,6,528,282
58806,15,86,98,2,188,18,15,407,95
72447,16,94,113,2,116,4,12,341,101
56234,15,85,52,1,96,2,8,244,57
124819,30,85,83,0,61,2,10,241,221
79133,18,62,2,1,61,1,8,135,114
80321,18,71,38,0,118,3,5,235,116
1842,2,75,191,1,68,9,9,353,130
123026,30,103,66,1,179,4,2,355,217
92637,21,40,127,1,62,1,10,241,161
11476,7,198,10,1,96,1,19,325,258
5926,4,63,152,1,139,16,11,382,243
38336,11,52,82,2,75,3,11,225,9
13745,7,75,87,2,182,7,9,362,264
60471,15,61,78,6,231,15,6,397,60
19693,8,117,60,3,6,0,8,194,273
43008,12,97,9,0,60,0,3,169,27
31109,9,22,131,4,210,20,7,394,292
27605,9,16,67,0,269,18,8,378,282
129217,32,5,26,1,10,0,1,43,239
126439,31,187,138,0,8,1,3,337,233
98878,23,53,230,1,121,7,4,416,170
123587,30,46,102,0,176,16,8,348,218
116660,29,32,88,0,148,6,9,283,209
14310,7,111,39,1,194,3,15,363,255
52453,14,125,210,5,70,25,8,443,40
35980,11,66,328,1,32,12,6,445,17
42770,12,41,16,1,45,3,2,108,26
96962,22,83,158,1,81,9,17,349,166
110469,27,118,11,0,224,0,11,364,195
15639,8,53,88,5,23,5,6,180,266
28514,9,29,45,2,271,12,6,365,284
116286,29,41,166,4,122,10,6,349,208
93292,21,75,147,2,119,10,9,362,163
39616,11,48,256,8,72,17,20,421,12
83861,19,229,40,1,28,49,0,347,128
110623,27,165,27,0,237,4,4,437,196
91658,21,82,72,12,97,3,6,272,159
74682,16,35,147,1,69,8,1,261,106
44599,12,58,36,1,141,6,9,251,30
20519,9,24,237,2,81,8,0,352,285
82987,19,76,241,3,70,10,9,409,126
6327,4,61,38,6,105,3,7,220,243
58677,15,49,119,5,210,19,10,412,94
126022,30,67,67,0,177,1,11,323,225
27502,9,25,69,5,309,21,22,451,282
87932,20,81,70,0,74,6,6,237,144
59905,15,72,90,3,188,19,13,385,59
4480,2,49,105,5,65,10,9,243,136
117491,30,96,61,1,131,2,4,295,223
52254,14,102,145,8,88,21,9,373,40
413,1,85,162,7,106,21,7,388,2
93625,21,100,156,2,88,16,5,367,149
21346,9,39,95,4,326,26,8,498,295
87851,20,67,17,1,51,3,19,158,144
29890,9,8,41,0,307,3,12,371,289
83869,19,126,40,2,52,60,22,302,128
73040,16,50,93,3,138,4,2,290,103
117444,30,48,75,0,80,69,11,283,212
4101,2,66,78,2,42,13,6,207,135
32101,10,123,152,27,75,7,0,384,4
12051,7,89,67,1,188,9,7,361,260
74213,16,53,58,1,102,3,17,234,105
106828,26,69,70,0,45,1,7,192,186
68954,15,107,179,5,93,16,18,418,84
47604,13,62,71,1,213,10,1,358,37
104940,25,104,107,0,77,6,11,305,183
27591,9,25,304,1,74,12,4,420,282
116985,29,43,97,3,158,13,9,323,209
110291,27,122,18,0,190,2,1,333,195
87180,20,128,103,0,81,3,0,315,143
80113,18,87,49,10,108,5,6,265,116
58371,15,43,282,5,161,22,5,518,94
84184,19,99,172,6,74,11,17,379,128
34007,10,67,262,3,45,9,9,395,7
43894,12,15,7,0,88,1,5,116,28
103982,25,71,67,0,69,6,9,222,181
22692,9,34,81,0,255,15,5,390,298
36420,11,25,347,0,26,9,0,407,18
70718,15,36,68,3,183,6,9,305,88
53455,14,79,260,3,77,18,12,449,43
115162,28,77,97,4,93,3,16,290,205
62769,15,49,134,6,264,31,0,484,65
45802,13,57,79,5,135,10,5,291,33
14751,7,57,56,3,123,4,8,251,256
24249,9,24,102,1,150,14,4,295,275
36864,11,54,230,3,13,3,12,315,19
52053,14,71,195,7,60,17,0,350,40
71349,15,112,87,1,87,6,3,296,91
43265,12,72,17,11,96,0,11,207,27
123076,30,65,139,0,86,0,6,296,217
34445,11,45,143,1,112,6,17,324,8
36795,11,101,263,2,31,12,0,409,18
24724,9,39,67,0,205,13,5,329,276
37551,11,40,218,0,18,5,8,289,20
98952,23,61,226,7,118,29,3,444,170
113897,28,75,108,3,85,9,16,296,202
107069,26,53,108,1,52,3,7,224,187
123124,30,102,90,0,112,4,11,319,217
71960,16,9,22,1,83,0,4,119,97
2022,2,55,59,1,56,5,6,182,130
83930,19,70,114,3,12,3,6,208,128
2994,2,43,177,3,57,8,3,291,133
118366,30,56,176,2,97,7,3,341,227
90965,21,83,186,1,154,15,8,447,157
31704,9,29,90,2,218,23,4,366,293
25326,9,36,70,0,205,14,2,327,277
15583,8,52,79,4,28,5,4,172,266
41436,12,61,17,0,91,2,1,172,23
128201,31,286,180,0,31,2,16,515,237
34391,11,48,110,0,56,2,9,225,8
91941,21,60,193,1,127,25,10,416,160
63632,15,53,163,0,193,29,4,442,67
127992,31,130,172,0,52,1,7,362,237
29262,9,29,90,1,264,9,5,398,287
105257,25,14,26,0,10,0,1,51,183
129200,32,28,23,1,10,2,9,73,239
59666,15,57,91,1,214,6,12,381,58
7503,5,65,141,2,75,9,5,297,246
100200,24,30,131,1,97,4,11,274,173
111272,27,133,6,3,210,2,16,370,197
26535,9,38,141,5,181,12,7,384,280
15703,8,116,91,3,35,11,10,266,266
107058,26,61,124,3,58,4,4,254,187
61422,15,67,138,2,197,11,6,421,62
3578,2,54,88,9,58,9,6,224,134
114343,28,95,85,5,95,6,8,294,203
21247,9,18,93,1,180,13,6,311,295
128242,31,67,173,0,44,0,11,295,237
24919,9,29,182,2,132,13,9,367,277
61465,15,37,191,1,148,23,8,408,62
60741,15,64,68,5,218,17,21,393,61
82037,19,62,228,6,51,10,2,359,123
14045,7,13,16,1,209,2,11,252,254
89488,20,106,20,0,198,3,18,345,138
88456,20,50,74,8,165,11,7,315,146
97560,22,32,371,4,104,20,4,535,167
71827,16,28,30,4,206,4,7,279,97
36347,11,53,190,1,9,13,9,275,17
6532,5,22,31,2,7,0,0,62,244
64757,15,65,73,3,167,3,5,316,71
43988,12,28,8,2,37,0,4,79,29
81501,19,73,281,8,66,6,4,438,122
66785,15,98,115,6,188,23,11,441,77
26418,9,22,160,4,182,17,5,390,280
93006,21,66,186,9,134,16,2,413,163
23956,9,121,127,7,198,20,16,489,275
22311,9,24,61,4,260,19,1,369,297
17530,8,115,243,7,44,12,11,432,270
109286,26,49,121,2,105,5,6,288,192
116552,29,58,101,2,137,9,14,321,208
3080,2,57,131,3,57,15,8,271,133
109418,27,210,27,1,153,2,5,398,193
124098,30,151,79,2,33,8,3,276,220
98629,23,109,106,5,123,10,10,363,169
50210,14,62,115,3,46,15,9,250,53
46861,13,91,89,10,133,9,6,338,35
6200,4,79,146,10,72,7,24,338,243
65635,15,114,64,2,138,9,18,345,74
48198,14,83,103,21,127,29,13,376,38
35133,11,42,239,2,43,16,8,350,15
105049,25,70,31,2,40,1,2,146,183
48470,14,64,259,3,55,10,4,395,49
52032,14,102,175,3,65,20,17,382,39
84693,19,72,101,6,68,8,11,266,119
114794,28,107,66,3,23,0,4,203,204
115946,29,63,78,1,197,1,21,361,207
64588,15,96,144,0,103,8,7,358,71
64369,15,88,70,3,139,19,4,323,70
68035,15,35,61,6,265,23,13,403,81
52202,14,128,200,5,190,25,8,556,40
127818,31,124,190,1,59,18,20,412,236
123909,30,151,110,4,126,9,18,418,219
112452,28,52,138,2,91,5,5,293,200
72419,16,90,195,1,55,4,8,353,101
50133,14,85,265,2,120,22,8,502,53
31668,9,37,47,2,249,8,5,348,293
67338,15,57,101,4,228,20,15,425,78
116036,29,41,128,3,155,11,61,399,207
29926,9,30,60,3,291,11,3,398,289
16002,8,59,186,4,32,15,0,296,267
30380,9,33,235,1,195,15,1,480,290
18715,8,27,26,3,12,2,4,74,272
97927,23,55,64,0,211,5,11,346,168
20221,9,24,73,0,186,13,3,299,285
45294,13,78,42,18,84,0,13,235,32
110959,27,119,15,0,218,2,9,363,196
71,1,92,97,12,44,3,6,254,1
35867,11,118,167,3,34,2,17,341,16
87744,20,45,22,0,69,4,11,151,144
88762,20,70,97,0,169,12,4,352,146
82594,19,65,190,1,37,8,9,310,125
113121,28,79,95,2,170,9,15,370,201
105414,25,71,103,1,23,5,7,210,183
88393,20,148,15,0,138,0,1,302,145
2910,2,30,106,1,56,12,6,211,133
39128,11,54,146,5,44,5,10,264,11
11626,7,48,89,2,85,4,7,235,259
186,1,110,156,10,50,3,9,338,1
97194,22,42,282,2,48,9,2,385,166
106406,26,45,137,1,119,3,3,308,186
89391,20,152,73,5,77,10,31,348,138
16578,8,76,52,2,41,4,3,178,268
35811,11,56,155,2,54,10,14,291,16
97779,22,102,115,7,56,4,23,307,167
59123,15,128,33,0,77,2,5,245,96
117579,30,101,52,1,160,3,18,335,223
79772,18,92,133,4,184,13,3,429,115
86480,20,34,6,0,62,3,5,110,141
70586,15,55,74,3,220,14,12,378,88
124936,30,102,104,12,149,11,12,390,221
77969,17,34,72,12,138,16,10,282,111
38820,11,144,97,2,71,6,11,331,10
115674,28,125,159,8,53,1,23,369,206
116203,29,61,85,1,132,14,13,306,207
402,1,49,141,3,74,9,7,283,2
52871,14,84,142,3,58,9,8,304,42
72791,16,51,127,6,119,12,12,327,102
85554,20,71,39,0,121,4,9,244,137
101141,24,82,248,1,91,18,2,442,175
14757,7,81,67,1,122,7,8,286,256
98452,23,132,145,3,109,10,11,410,169
128400,32,41,86,4,66,5,14,216,238
91866,21,52,133,3,136,7,14,345,159
129680,32,63,126,3,99,3,18,312,239
83722,19,84,248,2,69,8,2,413,128
60742,15,64,87,6,206,19,10,392,61
66919,15,46,106,7,179,8,8,354,77
93451,21,33,184,5,129,6,4,361,149
88424,20,112,77,6,200,21,9,425,146
30399,9,33,99,2,219,18,2,373,290
62594,15,55,106,3,239,27,8,438,65
130754,32,9,9,1,230,0,7,256,241
92926,21,56,101,7,129,6,16,315,162
31816,9,48,74,1,245,15,6,389,293
53987,14,215,103,5,139,13,3,478,44
105334,25,85,39,0,24,0,10,158,183
109644,27,58,8,2,227,1,5,301,193
22231,9,44,91,1,281,10,5,432,297
11407,7,34,6,1,11,0,2,54,258
32940,10,72,158,3,109,8,6,356,5
46699,13,84,95,4,111,5,5,304,35
2281,2,62,129,5,82,16,5,299,131
122899,30,38,89,0,58,0,2,187,217
31638,9,24,60,1,336,14,8,443,293
99888,24,41,54,0,22,2,15,134,172
85626,20,78,93,0,135,9,13,328,137
66319,15,65,241,2,111,24,12,455,76
113947,28,201,114,1,85,2,11,414,203
126387,31,111,137,0,15,3,17,283,233
4932,3,74,80,5,108,2,11,280,210
124448,30,85,108,0,68,4,16,281,220
19311,8,30,22,0,21,3,4,80,273
28569,9,27,83,2,362,18,6,498,286
88252,20,168,4,0,139,1,7,319,145
121907,30,53,150,1,61,12,12,289,215
4002,2,30,71,0,41,8,6,156,135
20552,9,26,205,0,85,9,5,330,285
93722,21,16,40,2,56,1,15,130,149
94147,21,57,169,2,119,13,13,373,150
120429,30,66,105,3,108,5,11,298,231
89628,20,98,12,0,170,2,9,291,139
96882,22,69,178,2,96,2,21,368,165
36357,11,69,319,4,52,16,19,479,17
30727,9,35,96,6,340,13,4,494,291
75698,16,38,163,2,116,9,10,338,98
83223,19,87,108,3,53,4,18,273,126
84905,19,75,138,7,75,14,14,323,119
47102,13,80,108,3,117,7,5,320,36
1449,2,75,166,4,77,9,29,360,129
84842,19,76,140,0,44,11,12,283,119
123329,30,46,169,1,178,12,12,418,218
20783,9,42,212,0,189,15,7,465,294
42072,12,23,38,5,102,5,7,180,25
77101,17,37,130,5,155,11,14,352,109
111288,27,159,12,0,221,1,5,398,197
49028,14,61,213,0,18,4,4,300,50
119311,30,79,84,1,162,8,7,341,229
27986,9,29,50,2,215,21,9,326,283
19553,8,48,191,5,42,15,7,308,273
52848,14,91,220,6,36,12,6,371,41
18389,8,41,22,2,20,0,3,88,271
88288,20,81,87,0,90,4,22,284,145
123768,30,47,208,1,173,8,4,441,219
109659,27,106,2,1,256,5,5,375,193
71204,15,72,31,2,138,4,13,260,89
92114,21,44,151,4,115,11,9,334,160
92877,21,41,79,5,165,9,13,312,162
120896,30,69,32,6,126,5,5,243,232
16000,8,99,163,6,66,22,9,365,267
2836,2,41,71,2,53,8,13,188,132
20708,9,30,104,1,202,24,6,367,294
75999,16,28,247,1,84,11,1,372,98
77054,17,38,214,4,118,10,10,394,109
6053,4,77,120,0,126,8,12,343,243
55379,14,56,76,0,55,3,5,195,47
116998,29,34,83,3,139,14,8,281,209
15074,8,79,37,1,36,3,6,162,265
4280,2,56,102,6,54,9,4,231,135
124177,30,135,80,1,155,2,6,379,220
17166,8,48,97,6,72,9,9,241,269
17815,8,97,331,12,76,20,8,544,270
58679,15,72,120,6,202,15,10,425,94
78670,17,83,81,2,148,11,16,341,113
116001,29,42,141,2,117,16,16,334,207
70191,15,70,120,10,204,22,10,436,87
128064,31,126,181,1,20,1,14,343,237
39091,11,43,189,2,44,7,2,287,11
18837,8,104,151,2,68,12,8,345,272
129459,32,122,33,2,104,0,1,262,239
36010,11,52,318,2,30,15,4,421,17
126704,31,200,130,2,16,4,6,358,234
86631,20,8,3,0,42,0,1,54,141
88037,20,174,27,1,182,5,3,392,145
105492,25,39,42,1,47,0,7,136,184
21951,9,77,173,2,291,16,7,566,296
78740,17,43,89,7,190,15,11,355,113
43582,12,55,31,4,153,2,36,281,28
41725,12,98,256,7,362,19,9,751,24
19121,8,21,85,1,23,3,2,135,272
93274,21,65,111,3,86,3,5,273,163
74553,16,81,158,3,101,5,12,360,106
119622,30,79,146,5,76,6,15,327,230
17237,8,103,82,4,47,7,12,255,269
22117,9,28,63,2,291,14,14,412,297
6260,4,126,147,0,65,4,15,357,243
9318,5,113,162,7,64,13,8,367,250
105051,25,135,114,1,24,5,7,286,183
1699,2,78,116,2,63,10,7,276,130
76902,16,68,248,5,65,0,10,396,100
108010,26,44,90,1,142,16,1,294,189
99137,24,59,179,0,60,17,16,331,171
64649,15,24,162,2,91,8,3,290,71
119969,30,54,116,1,84,7,20,282,230
107623,26,51,232,3,65,20,11,382,188
130277,32,54,44,2,84,4,5,193,241
95880,21,136,157,0,158,2,21,474,155
24448,9,25,98,3,274,23,6,429,276
23060,9,33,93,0,179,11,6,322,299
34584,11,36,40,0,4,0,0,80,8
10779,7,40,31,0,297,1,8,377,257
101622,24,35,197,3,70,20,12,337,176
64318,15,65,82,5,169,19,2,342,70
56012,15,104,151,3,87,14,21,380,57
35077,11,83,227,2,29,11,17,369,15
111472,27,145,21,1,195,5,9,376,198
120863,30,89,134,2,141,17,7,390,232
74906,16,53,242,1,134,10,13,453,107
75938,16,43,184,2,142,17,11,399,98
30844,9,16,58,2,243,17,5,341,291
30811,9,41,66,0,250,13,9,379,291
83905,19,78,97,44,61,2,20,302,128
55394,14,85,97,4,121,6,12,325,47
118015,30,85,86,2,150,7,9,339,226
123271,30,81,62,3,117,4,22,289,218
55280,14,59,116,3,167,9,5,359,47
67106,15,24,68,4,218,10,4,328,78
15092,8,71,52,3,55,4,3,188,265
78224,17,64,87,5,135,20,11,322,111
94288,21,47,174,2,114,13,13,363,151
32853,10,62,69,0,46,5,4,186,5
94833,21,170,21,1,30,2,17,241,152
89757,20,100,111,1,204,2,5,423,139
81552,19,79,277,2,71,9,11,449,122
103529,25,120,148,1,70,6,8,353,180
14292,7,113,35,2,158,2,19,329,255
22913,9,32,120,2,88,12,2,256,299
98664,23,53,80,1,102,8,9,253,170
37123,11,74,187,3,42,8,15,329,19
1668,2,58,150,1,52,12,3,276,130
79001,17,71,366,5,247,24,1,714,113
62065,15,57,57,5,194,16,4,333,64
127793,31,63,150,1,59,9,5,287,236
61139,15,33,77,2,188,15,3,318,61
61723,15,37,314,0,107,10,4,472,63
79609,18,77,36,1,97,7,7,225,115
73571,16,24,91,0,42,1,5,163,104
88858,20,25,66,2,86,3,17,199,147
46839,13,79,94,3,281,15,17,489,35
108942,26,85,107,2,53,7,15,269,191
128182,31,140,173,3,58,3,7,384,237
100542,24,30,102,1,59,3,1,196,174
60160,15,49,126,4,125,14,6,324,59
55647,14,113,181,6,115,13,10,438,48
33504,10,85,116,7,55,3,9,275,6
64993,15,100,165,7,125,19,12,428,72
112270,28,105,173,1,75,9,6,369,199
63730,15,52,77,5,214,26,3,377,69
94792,21,81,43,0,52,1,9,186,152
98612,23,63,52,2,92,5,8,222,169
58708,15,60,111,7,151,22,9,360,94
15395,8,140,80,6,81,3,10,320,265
50790,14,66,147,4,42,17,6,282,55
27737,9,35,241,1,181,11,3,472,283
47155,13,62,111,1,66,8,8,256,36
2353,2,78,116,8,69,5,7,283,131
7661,5,67,210,0,115,5,5,402,246
101604,24,50,196,0,61,26,10,343,176
65852,15,86,197,3,117,21,14,438,75
9742,6,118,190,1,108,1,9,427,251
15016,8,134,149,2,59,4,11,359,265
47808,13,59,60,15,212,8,5,359,37
123944,30,67,127,0,128,17,13,352,219
17517,8,83,253,5,44,11,16,412,270
24790,9,37,120,7,209,20,3,396,276
106384,25,47,136,1,155,8,8,355,185
42732,12,0,51,0,545,0,3,599,26
37633,11,54,190,10,49,17,17,337,20
26698,9,35,221,5,195,32,9,497,280
26591,9,27,209,0,143,6,5,390,280
82029,19,74,261,6,73,16,4,434,123
24531,9,33,94,3,285,19,5,439,276
66691,15,79,178,3,208,36,6,510,77
104176,25,115,63,1,139,2,18,338,181
84549,19,123,95,2,24,5,16,265,118
111396,27,137,16,1,211,2,3,370,198
32921,10,56,112,5,98,8,7,286,5
112024,28,45,81,2,35,5,7,175,199
44318,12,71,37,0,86,2,4,200,29
52508,14,183,116,6,44,5,18,372,41
111771,27,95,14,0,197,1,14,321,198
28786,9,37,92,1,216,9,10,365,286
87489,20,81,36,1,215,2,10,345,143
92389,21,78,130,5,113,6,14,346,161
34744,11,41,186,3,73,2,14,319,14
103280,25,30,31,1,13,5,2,82,179
88725,20,79,74,4,183,10,9,359,146
61861,15,43,315,2,75,19,4,458,63
65173,15,41,96,1,148,8,7,301,73
49254,14,87,148,7,69,18,7,336,51
72313,16,44,172,1,134,5,9,365,101
63277,15,68,158,3,174,26,14,443,67
54229,14,78,253,2,60,15,7,415,45
35890,11,77,234,4,14,3,5,337,17
75207,16,71,23,2,134,0,8,238,108
123107,30,20,89,1,43,1,5,159,217
63156,15,90,233,1,101,15,12,452,66
30838,9,18,60,1,273,11,6,369,291
92751,21,19,96,1,170,6,15,307,162
24817,9,33,92,0,154,8,16,303,276
34380,11,68,199,0,22,2,20,311,8
96056,22,99,69,1,132,5,9,315,164
91103,21,134,57,2,67,7,23,290,157
89051,20,47,33,3,61,2,17,163,147
75170,16,65,135,1,102,9,18,330,107
112894,28,80,64,2,71,0,0,217,201
26814,9,30,139,2,307,22,8,508,281
72826,16,50,100,7,93,15,12,277,102
13561,7,54,109,0,71,8,8,250,264
118996,30,108,200,0,120,4,10,442,228
65922,15,96,224,5,99,29,4,457,75
53264,14,94,250,4,64,19,9,440,42
24898,9,32,115,2,141,20,5,315,277
34314,11,51,178,1,36,8,11,285,8
92342,21,40,118,0,150,0,7,315,161
122496,30,53,177,1,89,1,12,333,216
44733,12,78,52,5,117,8,5,265,30
27947,9,30,101,3,295,16,3,448,283
15121,8,76,62,9,34,7,7,195,265
40803,12,26,32,1,106,3,3,171,22
54465,14,89,149,7,60,7,13,325,45
117060,30,87,136,1,138,2,8,372,212
31255,9,32,73,1,243,19,6,374,292
47218,13,48,93,1,87,8,6,243,36
108638,26,49,152,4,126,12,6,349,191
32038,10,99,98,3,46,3,11,260,4
28903,9,26,121,5,227,16,9,404,286
106669,26,69,136,4,66,12,5,292,186
126581,31,75,137,1,90,4,6,313,233
38117,11,91,217,3,24,8,16,359,21
40134,11,96,31,2,92,9,15,245,13
67792,15,58,88,5,245,18,12,426,81
5145,3,51,72,2,154,14,10,303,211
33394,10,15,18,0,11,0,1,45,6
48742,14,150,172,2,25,9,7,365,49
11784,7,97,7,1,120,0,12,237,259
124212,30,102,68,0,110,2,6,288,220
29868,9,22,69,1,357,16,8,473,289
44032,12,54,5,12,39,1,6,117,29
85873,20,148,48,2,156,2,16,372,137
124561,30,156,114,1,129,4,13,417,220
62416,15,28,90,2,191,9,8,328,65
61387,15,60,154,3,150,17,10,394,62
19325,8,124,104,23,78,11,6,346,273
3887,2,36,77,2,49,7,4,175,134
94773,21,106,46,0,124,4,9,289,152
81940,19,85,196,196,52,14,11,554,123
14333,7,55,40,3,184,2,11,295,255
111113,27,94,2,1,180,0,0,277,197
59804,15,52,117,4,187,17,9,386,58
96380,22,88,214,1,85,4,10,402,164
128908,32,19,48,1,56,0,7,131,238
12732,7,59,116,0,145,5,5,330,262
32109,10,64,153,2,56,2,19,296,4
112552,28,49,127,1,80,7,11,275,200
94662,21,62,98,0,97,5,3,265,152
5315,3,41,97,2,156,11,8,315,211
76586,16,30,42,2,91,2,4,171,100
4287,2,47,74,3,97,6,3,230,135
21715,9,39,99,5,353,28,8,532,296
96240,22,74,109,3,21,0,20,227,164
117582,30,98,90,2,105,5,8,308,223
55664,14,99,61,12,77,0,9,258,48
95826,21,88,63,2,137,0,11,301,155
9680,6,17,25,0,9,0,2,53,251
105952,25,57,174,1,78,10,6,326,185
117533,30,77,92,0,97,5,18,289,223
64479,15,58,234,3,163,24,8,490,71
128054,31,97,201,1,38,3,18,358,237
109913,27,113,7,0,239,3,12,374,194
46406,13,102,17,3,113,1,24,260,34
66722,15,53,115,3,157,17,6,351,77
47939,14,155,32,12,96,0,4,299,38
101090,24,44,143,2,80,16,8,293,175
87107,20,78,70,3,112,12,13,288,142
35450,11,56,171,3,47,18,9,304,16
14797,7,71,94,2,167,6,17,357,256
18864,8,63,146,2,19,3,3,236,272
2751,2,63,106,0,42,8,2,221,132
56228,15,68,97,5,157,2,11,340,57
65895,15,150,105,8,41,20,12,336,75
121444,30,59,81,2,170,7,7,326,214
30419,9,39,201,0,308,18,0,566,290
19494,8,43,141,5,44,13,5,251,273
41419,12,9,4,1,71,0,0,85,23
15398,8,71,117,0,43,10,6,247,265
126147,30,134,208,1,66,1,9,419,225
37924,11,64,224,3,45,10,14,360,21
23479,9,43,75,4,211,16,6,355,300
112905,28,67,91,1,79,8,13,259,201
126520,31,155,151,2,48,1,11,368,233
61262,15,66,136,1,152,12,16,383,62
129717,32,92,74,3,75,2,3,249,240
49374,14,84,287,1,104,28,7,511,51
113049,28,60,108,3,54,11,7,243,201
34106,10,80,186,1,77,9,8,361,7
105550,25,59,116,1,112,7,11,306,184
54029,14,56,198,3,5,3,14,279,44
100791,24,20,91,1,48,1,14,175,174
48619,14,42,231,2,19,4,9,307,49
72338,16,35,26,1,146,1,6,215,101
40971,12,107,13,2,67,1,7,197,23
117052,30,95,112,2,115,11,5,340,212
57476,15,88,108,3,139,12,7,357,90
55257,14,85,210,5,97,11,7,415,47
128868,32,37,81,4,166,9,11,308,238
20106,9,13,38,2,235,12,4,304,274
58206,15,58,158,1,192,30,5,444,93
57102,15,100,156,5,190,32,13,496,90
41253,12,52,150,4,140,9,9,364,23
15750,8,102,85,0,23,9,13,232,266
22520,9,44,100,0,226,21,5,396,298
8638,5,94,91,1,61,6,6,259,248
95568,21,70,120,1,76,10,7,284,154
101290,24,42,183,3,72,9,10,319,176
111942,28,91,111,2,72,10,13,299,199
29026,9,49,49,0,297,21,11,427,287
4386,2,71,93,5,50,4,5,228,136
1061,1,65,70,2,43,4,10,194,3
103774,25,84,93,1,29,2,1,210,180
113966,28,63,22,1,36,5,7,134,203
42120,12,38,78,7,228,12,16,379,25
49832,14,101,161,1,80,10,7,360,52
103093,25,60,119,0,54,5,4,242,179
114093,28,90,171,14,172,5,7,459,203
61552,15,43,357,1,53,9,5,468,63
76215,16,82,2,0,89,1,1,175,99
41241,12,71,140,4,114,6,14,349,23
3213,2,60,108,2,69,3,7,249,133
111067,27,179,5,9,191,2,19,405,197
104829,25,77,75,1,67,5,7,232,182
71155,15,82,88,3,230,20,8,431,89
5459,4,79,129,8,114,12,10,352,242
41474,12,47,15,0,162,1,7,232,23
21176,9,39,90,0,227,19,8,383,295
50576,14,85,196,4,79,24,16,404,54
12996,7,41,18,1,30,4,3,97,262
28649,9,29,75,2,200,18,10,334,286
25136,9,44,118,2,239,15,10,428,277
113199,28,94,115,6,180,14,12,421,201
107426,26,63,216,3,58,10,1,351,188
55930,14,95,104,14,161,13,27,414,48
80525,19,21,308,0,23,3,1,356,117
30331,9,34,112,2,185,32,4,369,290
43663,12,76,61,7,185,10,8,347,28
40619,12,54,5,0,99,0,5,163,22
3479,2,38,77,0,44,8,0,167,134
82918,19,68,144,3,64,10,8,297,126
17202,8,102,170,8,49,9,10,348,269
21844,9,29,207,0,133,9,1,379,296
32252,10,45,14,0,2,0,2,63,4
28109,9,32,72,5,204,12,8,333,283
107981,26,62,162,2,142,15,4,387,189
82503,19,66,418,3,62,10,5,564,125
4913,3,36,169,1,132,5,10,353,210
126441,31,255,165,1,17,1,2,441,233
8177,5,53,32,0,4,0,1,90,247
89279,20,50,71,3,205,9,10,348,138
13281,7,116,31,2,72,3,9,233,263
19945,9,42,28,1,222,7,14,314,274
123273,30,105,23,1,53,1,16,199,218
46447,13,105,44,8,41,3,10,211,34
127080,31,88,242,0,78,18,6,432,235
70257,15,37,71,8,179,20,5,320,87
107082,26,25,134,1,29,2,1,192,187
15753,8,54,71,2,35,4,0,166,266
105925,25,130,107,4,34,2,7,284,184
114746,28,76,119,2,18,0,7,222,204
23565,9,28,53,5,207,13,9,315,300
81316,19,76,75,1,41,8,13,214,122
61210,15,55,100,3,176,20,7,361,62
109559,27,152,3,0,227,0,4,386,193
121976,30,93,151,2,120,14,7,387,215
90705,21,121,97,1,53,6,22,300,156
23176,9,44,73,2,212,2,3,336,299
91524,21,108,51,5,166,1,21,352,158
123215,30,108,54,0,23,2,21,208,218
110069,27,143,10,1,274,5,18,451,194
124458,30,66,110,0,94,1,10,281,220
104715,25,63,107,5,74,6,7,262,182
33437,10,95,81,2,36,3,4,221,6
45272,13,40,26,0,158,2,0,226,32
89711,20,176,12,0,151,0,11,350,139
117563,30,87,75,3,154,0,14,333,223
29960,9,31,60,0,298,20,10,419,289
70248,15,36,75,1,136,15,6,269,87
13464,7,74,41,2,133,4,16,270,264
102104,25,1,20,0,13,0,0,34,178
3198,2,74,137,6,51,14,14,296,133
69328,15,86,128,6,133,13,18,384,85
106544,26,8,11,0,12,1,2,34,186
37752,11,70,337,4,49,10,9,479,21
96716,22,66,168,5,94,13,6,352,165
68293,15,75,59,5,216,16,16,387,82
129746,32,24,3,0,23,0,4,54,240
88116,20,391,3,1,151,0,8,554,145
118981,30,113,349,3,265,15,14,759,228
107019,26,74,195,6,56,5,3,339,187
69119,15,84,225,6,84,13,17,429,84
88327,20,70,26,0,15,0,2,113,145
24701,9,27,46,3,175,10,9,270,276
15367,8,87,151,9,76,17,2,342,265
109236,26,56,103,2,132,4,7,304,192
63864,15,46,152,1,188,9,0,396,69
94174,21,158,87,1,57,3,15,321,150
99076,24,99,73,1,17,16,18,224,171
102395,25,115,107,4,52,2,5,285,178
74304,16,44,66,0,43,1,14,168,105
113071,28,68,166,1,111,9,13,368,201
66887,15,119,69,5,93,21,17,324,77
129214,32,22,10,0,10,0,0,42,239
104756,25,75,6,7,24,1,3,116,182
16664,8,97,90,7,47,10,5,256,268
52708,14,131,188,8,50,11,15,403,41
13226,7,90,17,1,104,2,5,219,263
29670,9,32,41,3,235,8,4,323,288
80882,19,85,128,37,59,11,14,334,117
117779,30,66,169,0,88,5,1,329,223
42381,12,50,52,6,144,10,7,269,25
121952,30,37,138,0,64,4,5,248,215
55288,14,60,119,7,191,12,7,396,47
51917,14,43,287,1,55,12,3,401,39
90036,21,84,106,3,129,2,9,333,148
104583,25,62,107,4,107,8,0,288,182
85216,19,93,93,29,111,3,7,336,120
123621,30,110,125,2,173,7,23,440,219
21668,9,23,159,1,199,17,7,406,296
33516,10,110,152,6,35,7,6,316,6
50859,14,54,133,3,56,14,2,262,55
10320,7,154,2,0,44,1,10,211,253
27463,9,18,81,4,245,15,3,366,282
55344,14,102,180,2,60,6,13,363,47
85253,19,113,56,6,11,1,4,191,120
42715,12,108,11,0,142,2,0,263,26
129078,32,27,79,2,41,7,11,167,239
115235,28,66,164,2,130,13,6,381,205
20475,9,24,168,1,100,13,2,308,285
70687,15,56,99,7,164,11,6,343,88
117005,29,23,117,2,184,5,7,338,209
53150,14,118,189,5,110,18,11,451,42
84495,19,40,444,2,33,11,4,534,118
88046,20,196,23,0,222,4,10,455,145
59638,15,67,85,4,203,26,12,397,58
39403,11,49,250,4,55,12,7,377,11
7596,5,99,209,8,101,10,7,434,246
67299,15,37,96,6,223,9,8,379,78
87199,20,166,9,0,141,0,6,322,143
2016,2,85,145,4,55,14,24,327,130
91529,21,90,52,5,138,3,15,303,158
118204,30,35,68,5,91,11,14,224,226
17967,8,89,131,2,49,13,7,291,270
78188,17,50,55,12,212,11,7,347,111
130017,32,128,111,2,132,9,10,392,240
11484,7,123,5,5,99,1,14,247,258
54236,14,75,182,4,73,15,8,357,45
8802,5,77,115,3,70,7,3,275,249
44688,12,72,69,9,167,16,11,344,30
36839,11,80,306,3,22,7,4,422,19
56447,15,64,70,4,206,19,4,367,68
66998,15,64,65,2,173,16,15,335,78
68733,15,65,92,6,214,21,12,410,83
67391,15,59,78,4,233,6,12,392,80
109387,26,87,47,3,72,0,5,214,192
113406,28,92,131,2,69,7,6,307,201
107425,26,73,190,5,54,19,9,350,188
127382,31,93,163,1,56,13,13,339,235
52384,14,76,183,3,66,19,8,355,40
79134,18,88,8,10,18,2,0,126,114
34780,11,74,128,7,34,4,7,254,14
97568,22,45,241,9,95,14,2,406,167
109109,26,81,119,2,146,1,4,353,192
89940,20,133,53,3,199,7,6,401,139
27081,9,17,83,2,260,11,4,377,281
38165,11,68,179,1,23,5,10,286,21
2549,2,65,156,5,62,9,7,304,132
17827,8,105,299,8,56,8,9,485,270
68510,15,42,79,1,93,24,6,245,83
108660,26,38,186,4,110,14,8,360,191
69021,15,60,219,3,87,11,8,388,84
90847,21,93,81,1,59,1,28,263,157
116151,29,48,110,3,148,7,3,319,207
120537,30,41,11,3,55,0,5,115,232
12529,7,43,91,2,166,7,4,313,261
57415,15,50,103,5,182,15,15,370,90
107552,26,44,181,6,58,13,4,306,188
75720,16,34,140,2,106,6,4,292,98
4782,3,68,153,1,128,7,0,357,210
110742,27,115,17,2,127,4,1,266,196
105669,25,78,105,0,128,12,11,334,184
126831,31,134,161,5,48,3,21,372,234
51780,14,59,278,6,81,14,8,446,39
4068,2,81,223,1,81,16,10,412,135
60626,15,37,100,2,258,29,4,430,60
108674,26,29,127,2,64,0,0,222,191
78659,17,39,77,1,111,14,14,256,112
91503,21,31,127,10,101,0,14,283,158
56653,15,68,83,4,135,8,6,304,68
96348,22,127,53,0,38,1,28,247,164
22710,9,23,45,3,206,18,8,303,298
50662,14,108,180,3,108,15,10,424,54
20606,9,35,84,1,181,9,5,315,285
118353,30,60,158,1,69,7,6,301,227
25846,9,17,63,4,326,8,7,425,279
49347,14,56,253,2,95,23,5,434,51
34381,11,97,187,0,28,3,15,330,8
15916,8,96,59,7,31,5,1,199,266
55910,14,64,158,33,90,6,14,365,48
48695,14,87,172,4,48,8,14,333,49
18230,8,34,20,0,3,1,1,59,271
81535,19,38,390,2,48,11,3,492,122
72278,16,143,61,0,63,4,6,277,101
121024,30,48,97,2,148,14,10,319,213
13641,7,63,99,0,133,13,15,323,264
72863,16,94,86,4,152,5,27,368,102
86240,20,118,91,1,283,11,9,513,140
122628,30,55,174,2,120,4,6,361,216
50244,14,129,223,6,93,21,14,486,53
93608,21,96,255,4,85,8,8,456,149
128008,31,149,182,1,11,1,18,362,237
78022,17,45,54,4,122,7,12,244,111
72700,16,69,40,1,157,1,2,270,102
6480,5,58,86,4,49,10,7,214,244
58426,15,64,148,4,215,21,0,452,94
96228,22,141,155,3,133,9,11,452,164
5562,4,97,119,7,145,12,11,391,242
82318,19,117,125,6,57,6,16,327,124
99182,24,80,204,1,73,15,16,389,171
120680,30,41,72,1,94,9,9,226,232
75614,16,51,57,1,53,5,11,178,108
43913,12,90,38,12,174,20,9,343,28
103659,25,59,61,0,60,4,10,194,180
10759,7,189,13,2,14,5,12,235,257
16613,8,73,109,6,40,9,6,243,268
112629,28,51,121,2,87,14,10,285,200
125406,30,48,84,2,99,1,7,241,224
83024,19,76,151,3,35,7,7,279,126
12307,7,69,43,3,103,3,10,231,261
21619,9,29,123,2,173,10,4,341,296
98788,23,68,69,2,92,12,8,251,170
93965,21,51,229,4,162,21,0,467,150
106249,25,55,102,2,87,8,19,273,185
89988,20,106,55,0,97,2,1,261,139
9212,5,109,238,7,79,26,10,469,250
113630,28,40,97,2,81,6,9,235,202
75920,16,32,177,2,99,10,5,325,98
84338,19,49,117,3,36,11,11,227,118
31418,9,27,147,4,186,14,3,381,292
130278,32,44,42,2,78,2,14,182,241
42534,12,57,41,0,134,4,15,251,25
16340,8,73,94,7,66,12,5,257,267
76937,16,24,141,1,72,2,9,249,100
35091,11,30,392,2,46,14,4,488,15
72697,16,122,11,3,175,1,10,322,102
3176,2,58,139,1,39,10,2,249,133
99420,24,51,82,26,39,1,22,221,171
53609,14,86,238,24,46,15,2,411,43
31409,9,30,31,5,289,14,8,377,292
49693,14,56,52,2,13,5,2,130,52
20421,9,36,179,1,132,15,5,368,285
7135,5,51,72,0,44,10,4,181,245
79803,18,83,47,5,155,9,9,308,115
119546,30,62,157,1,73,1,8,302,229
123835,30,68,150,1,159,14,7,399,219
34443,11,56,145,3,140,15,10,369,8
104220,25,28,71,3,103,3,6,214,181
51279,14,114,212,8,85,28,10,457,56
95204,21,60,93,8,172,11,8,352,153
32525,10,26,72,0,1,0,1,100,4
30310,9,35,115,2,276,13,10,451,290
6286,4,78,56,16,137,3,21,311,243
115239,28,77,140,3,149,7,20,396,205
79037,17,40,82,11,91,13,10,247,113
66165,15,75,158,3,87,8,11,342,75
16914,8,35,70,0,15,0,7,127,269
73551,16,41,121,5,51,0,9,227,104
109878,27,127,8,2,174,0,4,315,194
96565,22,51,41,7,63,3,9,174,165
75316,16,55,143,1,176,12,10,397,108
88148,20,142,50,1,120,2,11,326,145
30213,9,42,195,2,243,24,7,513,289
96550,22,74,126,7,124,4,29,364,165
78861,17,35,181,22,168,7,9,422,113
120481,30,33,129,1,87,0,14,264,231
114583,28,92,98,5,83,3,15,296,204
35160,11,55,270,2,28,16,11,382,15
57507,15,105,60,1,108,7,6,287,90
115884,29,40,134,2,159,10,17,362,207
61883,15,45,542,0,155,9,1,752,63
49605,14,46,177,1,27,3,7,261,52
126493,31,124,265,3,52,5,9,458,233
82244,19,184,64,1,49,13,18,329,124
57001,15,179,124,3,77,0,12,395,79
24222,9,23,161,0,125,11,1,321,275
114384,28,84,97,5,63,0,9,258,203
103827,25,160,98,1,161,3,2,425,180
101970,24,47,104,7,33,19,22,232,177
114332,28,83,131,9,107,5,11,346,203
8942,5,44,202,5,79,12,7,349,249
36904,11,69,194,28,89,9,11,400,19
113322,28,81,34,0,42,2,3,162,201
34480,11,3,30,0,4,0,1,38,8
12847,7,66,56,0,147,3,12,284,262
1631,2,70,121,4,78,10,6,289,130
100725,24,76,132,1,65,1,17,292,174
13013,7,97,42,1,109,1,18,268,262
80497,19,94,224,3,54,12,7,394,117
41042,12,70,78,4,152,15,9,328,23
85350,19,111,141,4,70,10,7,343,120
44136,12,43,17,0,64,0,3,127,29
43288,12,44,7,0,101,0,1,153,27
126891,31,237,141,0,22,3,10,413,234
108126,26,35,282,2,53,8,3,383,190
120117,30,182,39,0,61,10,8,300,231
50653,14,63,255,11,87,20,6,442,54
67142,15,53,95,2,246,22,12,430,78
5254,3,43,69,1,205,3,0,321,211
66177,15,116,195,3,89,12,18,433,75
24256,9,26,227,0,259,11,3,526,275
128485,32,41,108,3,147,13,24,336,238
47501,13,63,123,5,164,17,13,385,37
46166,13,120,69,2,105,11,16,323,33
110936,27,17,2,0,417,1,3,440,196
78467,17,82,59,12,180,6,7,346,112
48080,14,116,198,1,99,3,11,428,38
92679,21,98,134,3,116,16,10,377,162
44522,12,58,34,2,126,6,10,236,30
107289,26,61,103,1,37,7,6,215,187
6700,5,77,121,5,47,10,10,270,244
125724,30,77,75,2,105,3,19,281,224
11175,7,90,3,0,87,0,12,192,258
109415,27,1,4,0,4,0,1,10,193
56606,15,84,92,7,142,10,16,351,68
81737,19,94,190,5,74,17,4,384,123
31808,9,37,51,2,294,2,4,390,293
41570,12,48,9,1,117,7,5,187,24
